.........................
.........................
.........................
.........................
.........................
......##.................
......##...........##....
......##........#####....
................#####....
...................##....
.........................
.........................
.........................
.........................
.........................
................##.......
................##.......
................##.......
................###......
................###......
.........................
.........................
.........................
.........................
.........................

