.........................
.........................
.........................
....###............##....
....###............##....
....###.........#####....
....###.........#####....
....###.........#####....
...................##....
...................##....
.........................
.........................
.........................
.........................
................##.......
................##.......
................##.......
................##.......
................##.......
................#####....
................#####....
.........................
.........................
.........................
.........................