.........................
.........................
....#######..............
....#######..............
.........##..............
.........##..............
.........##..............
.........................
.........................
.........................
.........................
.........................
.........................
.........................
.........................
....##...................
....##...................
....#####.........###....
....#####.........###....
....#####.........###....
....##............###....
....##............###....
.........................
.........................
.........................