HumanMap-16-57-31
. . . . . . . . . . . . . . . . . . . . . . . . .
. . . . . . . . . . . . . . . . . . . . . . . . .
. . . . . . . . . . . . . . . . . . . . . . . . .
. . . . . . . . . . . . . . . . . . . . . . . . .
. . . . . . . . . . . . . . . . . . . . . . . . .
. . . . . . . . . . . . . . . . . . . . . . . . .
. . . . . . . . . . . . . . . .".".". . . . . . .
. . . . . . . . . . . . . . .".".".".".". . . . .
. . . . . . . . . . .".".".".".".".".".".". . . .
. . . . . . . . . .".".".".".".".".".".".". . . .
. . . . . . . . . ."."."."."."."*".".".".". . . .
. . . . . . . . ."."."."."."."."*".".".".". . . .
. . . . . . . . ."."."."*"*"*"*"*".".".".". . . .
. . . . . . . . ."."."."."."*"*"*".".".".". . . .
. . . . . . . . . .".".".".".".".".".".". . . . .
. . . . . . . . . ."."."."."."."."."."O". . . . .
. . . . . . . . . . . .".".".".".".". . . . . . .
. . . . . . . . . . . . . .".".".".". . . . . . .
. . . . . . . . . . . . . . . . . . . . . . . . .
. . . . . . . . . . . . . . . . . . . . . . . . .
. . . . . . . . . . . . . . . . . . . . . . . . .
. . . . . . . . . . . . . . . . . . . . . . . . .
. . . . . . . . . . . . . . . . . . . . . . . . .
. . . . . . . . . . . . . . . . . . . . . . . . .
. . . . . . . . . . . . . . . . . . . . . . . . .

RawMap-16-57-44
-31 -31 -31 -31 -31 -31 -31 -31 -31 -31 -31 -31 -31 -31 -31 -31 -31 -31 -31 -31 -31 -31 -31 -31 -31
-31 -31 -31 -31 -31 -31 -31 -31 -31 -31 -31 -31 -31 -31 -31 -31 -31 -31 -31 -31 -31 -31 -31 -31 -31
-31 -31 -31 -31 -31 -31 -31 -31 -31 -31 -31 -31 -31 -31 -31 -31 -31 -31 -31 -31 -31 -31 -31 -31 -31
-31 -31 -31 -31 -31 -31 -31 -31 -31 -31 -31 -31 -31 -31 -31 -31 -31 -31 -31 -31 -31 -31 -31 -31 -31
-31 -31 -31 -31 -31 -31 -31 -31 -31 -31 -31 -31 -31 -31 -31 -31 -31 -31 -31 -31 -31 -31 -31 -31 -31
-31 -31 -31 -31 -31 -31 -31 -31 -31 -31 -31 -31 -31 -31 -31 -31 -31 -31 -31 -31 -31 -31 -31 -31 -31
-31 -31 -31 -31 -31 -31 -31 -31 -31 -31 -31 -31 -31 -31 -31 -31 -31 -31 -31 -31 -31 -31 -31 -31 -31
-31 -31 -31 -31 -31 -31 -31 -31 -31 -31 -31 -31 -31 -31 -31 -31 -31 -31 -31 -31 -31 -31 -31 -31 -31
-31 -31 -31 -31 -31 -31 -31 -31 -31 -31 -31 0 0 0 -31 -31 -31 -31 -31 -31 -31 -31 -31 -31 -31
-31 -31 -31 -31 -31 -31 -31 -31 -31 0 0 0 0 0 0 9 -31 -31 -31 -31 -31 -31 -31 -31 -31
-31 -31 -31 -31 -31 -31 -31 -31 -31 0 0 0 0 0 0 0 -31 -31 -31 -31 -31 -31 -31 -31 -31
Failed to read line in map
-31 -31 -31 -31 -31 -31 -31 -31 6 0 0 0 0 0 0 0 1 -31 -31 -31 -31 -31 -31 -31 -31
-31 -31 -31 -31 -31 -31 -31 -31 -31 0 0 0 0 0 0 0 -31 -31 -31 -31 -31 -31 -31 -31 -31
-31 -31 -31 -31 -31 -31 -31 -31 -31 12 0 0 0 0 0 12 -31 -31 -31 -31 -31 -31 -31 -31 -31
-31 -31 -31 -31 -31 -31 -31 -31 -31 -31 -31 4 3 4 -31 -31 -31 -31 -31 -31 -31 -31 -31 -31 -31
-31 -31 -31 -31 -31 -31 -31 -31 -31 -31 -31 -31 -31 -31 -31 -31 -31 -31 -31 -31 -31 -31 -31 -31 -31
-31 -31 -31 -31 -31 -31 -31 -31 -31 -31 -31 -31 -31 -31 -31 -31 -31 -31 -31 -31 -31 -31 -31 -31 -31
-31 -31 -31 -31 -31 -31 -31 -31 -31 -31 -31 -31 -31 -31 -31 -31 -31 -31 -31 -31 -31 -31 -31 -31 -31
-31 -31 -31 -31 -31 -31 -31 -31 -31 -31 -31 -31 -31 -31 -31 -31 -31 -31 -31 -31 -31 -31 -31 -31 -31
-31 -31 -31 -31 -31 -31 -31 -31 -31 -31 -31 -31 -31 -31 -31 -31 -31 -31 -31 -31 -31 -31 -31 -31 -31
-31 -31 -31 -31 -31 -31 -31 -31 -31 -31 -31 -31 -31 -31 -31 -31 -31 -31 -31 -31 -31 -31 -31 -31 -31
-31 -31 -31 -31 -31 -31 -31 -31 -31 -31 -31 -31 -31 -31 -31 -31 -31 -31 -31 -31 -31 -31 -31 -31 -31
-31 -31 -31 -31 -31 -31 -31 -31 -31 -31 -31 -31 -31 -31 -31 -31 -31 -31 -31 -31 -31 -31 -31 -31 -31
Pose: X: 877.36 Y: 876.62 H: -2.38

RawMap-16-57-55
-31 -31 -31 -31 -31 -31 -31 -31 -31 -31 -31 -31 -31 -31 -31 -31 -31 -31 -31 -31 -31 -31 -31 -31 -31
-31 -31 -31 -31 -31 -31 -31 -31 -31 -31 -31 -31 -31 -31 -31 -31 -31 -31 -31 -31 -31 -31 -31 -31 -31
-31 -31 -31 -31 -31 -31 -31 -31 -31 -31 -31 -31 -31 -31 -31 -31 -31 -31 -31 -31 -31 -31 -31 -31 -31
-31 -31 -31 -31 -31 -31 -31 -31 -31 -31 -31 -31 -31 -31 -31 -31 -31 -31 -31 -31 -31 -31 -31 -31 -31
-31 -31 -31 -31 -31 -31 -31 -31 -31 -31 -31 -31 -31 -31 -31 -31 -31 -31 -31 -31 -31 -31 -31 -31 -31
-31 -31 -31 -31 -31 -31 -31 -31 -31 -31 -31 -31 -31 -31 -31 -31 -31 -31 -31 -31 -31 -31 -31 -31 -31
-31 -31 -31 -31 -31 -31 -31 -31 -31 -31 -31 -31 -31 -31 -31 -31 -31 -31 -31 -31 -31 -31 -31 -31 -31
-31 -31 -31 -31 -31 -31 -31 -31 -31 -31 -31 -31 -31 -31 -31 -31 -31 -31 -31 -31 -31 -31 -31 -31 -31
-31 -31 -31 -31 -31 -31 -31 -31 -31 -31 12 0 0 0 -31 -31 -31 -31 -31 -31 -31 -31 -31 -31 -31
-31 -31 -31 -31 -31 -31 -31 -31 -31 0 0 0 0 0 0 3 -31 -31 -31 -31 -31 -31 -31 -31 -31
-31 -31 -31 -31 -31 -31 -31 -31 4 0 0 0 0 0 0 0 -31 -31 -31 -31 -31 -31 -31 -31 -31
-31 -31 -31 -31 -31 -31 -31 -31 0 0 0 0 0 0 0 0 0 0 -31 -31 -31 -31 -31 -31 -31
-31 -31 -31 -31 -31 -31 -31 -31 0 0 0 0 100 100 0 0 0 0 0 9 -31 -31 -31 -31 -31
-31 -31 -31 -31 -31 -31 -31 -31 0 0 0 0 0 100 100 100 0 0 12 -31 -31 -31 -31 -31 -31
-31 -31 -31 -31 -31 -31 -31 -31 17 0 0 0 0 0 0 0 0 0 -31 -31 -31 -31 -31 -31 -31
-31 -31 -31 -31 -31 -31 -31 -31 -31 4 0 0 0 0 0 0 0 4 0 49 -31 -31 -31 -31 -31
-31 -31 -31 -31 -31 -31 -31 -31 -31 -31 -31 4 3 4 0 0 0 -31 -31 -31 -31 -31 -31 -31 -31
-31 -31 -31 -31 -31 -31 -31 -31 -31 -31 -31 -31 -31 -31 -31 23 0 23 -31 -31 -31 -31 -31 -31 -31
-31 -31 -31 -31 -31 -31 -31 -31 -31 -31 -31 -31 -31 -31 -31 -31 -31 -31 -31 -31 -31 -31 -31 -31 -31
-31 -31 -31 -31 -31 -31 -31 -31 -31 -31 -31 -31 -31 -31 -31 -31 -31 -31 -31 -31 -31 -31 -31 -31 -31
-31 -31 -31 -31 -31 -31 -31 -31 -31 -31 -31 -31 -31 -31 -31 -31 -31 -31 -31 -31 -31 -31 -31 -31 -31
-31 -31 -31 -31 -31 -31 -31 -31 -31 -31 -31 -31 -31 -31 -31 -31 -31 -31 -31 -31 -31 -31 -31 -31 -31
-31 -31 -31 -31 -31 -31 -31 -31 -31 -31 -31 -31 -31 -31 -31 -31 -31 -31 -31 -31 -31 -31 -31 -31 -31
-31 -31 -31 -31 -31 -31 -31 -31 -31 -31 -31 -31 -31 -31 -31 -31 -31 -31 -31 -31 -31 -31 -31 -31 -31
-31 -31 -31 -31 -31 -31 -31 -31 -31 -31 -31 -31 -31 -31 -31 -31 -31 -31 -31 -31 -31 -31 -31 -31 -31

RawMap-16-58-05
-31 -31 -31 -31 -31 -31 -31 -31 -31 -31 -31 -31 -31 -31 -31 -31 -31 -31 -31 -31 -31 -31 -31 -31 -31
-31 -31 -31 -31 -31 -31 -31 -31 -31 -31 -31 -31 -31 -31 -31 -31 -31 -31 -31 -31 -31 -31 -31 -31 -31
-31 -31 -31 -31 -31 -31 -31 -31 -31 -31 -31 -31 -31 -31 -31 -31 -31 -31 -31 -31 -31 -31 -31 -31 -31
-31 -31 -31 -31 -31 -31 -31 -31 -31 -31 -31 -31 -31 -31 -31 -31 -31 -31 -31 -31 -31 -31 -31 -31 -31
-31 -31 -31 -31 -31 -31 -31 -31 -31 -31 -31 -31 -31 -31 -31 -31 -31 -31 -31 -31 -31 -31 -31 -31 -31
-31 -31 -31 -31 -31 -31 -31 -31 -31 -31 -31 -31 -31 -31 -31 -31 -31 -31 -31 -31 -31 -31 -31 -31 -31
-31 -31 -31 -31 -31 -31 -31 -31 -31 -31 -31 -31 -31 -31 -31 -31 -31 -31 -31 -31 -31 -31 -31 -31 -31
-31 -31 -31 -31 -31 -31 -31 -31 -31 -31 -31 -31 -31 -31 -31 -31 -31 -31 -31 -31 -31 -31 -31 -31 -31
-31 -31 -31 -31 -31 -31 -31 -31 -31 -31 12 0 0 0 -31 -31 -31 -31 -31 -31 -31 -31 -31 -31 -31
-31 -31 -31 -31 -31 -31 -31 -31 -31 0 0 0 0 0 0 0 -31 -31 -31 -31 -31 -31 -31 -31 -31
-31 -31 -31 -31 -31 -31 -31 -31 4 0 0 0 0 0 0 0 0 -31 -31 -31 -31 -31 -31 -31 -31
-31 -31 -31 -31 -31 -31 -31 -31 0 0 0 0 0 0 0 0 0 0 0 -31 -31 -31 -31 -31 -31
-31 -31 -31 -31 -31 -31 -31 -31 0 0 0 0 100 100 0 0 0 0 0 4 -31 -31 -31 -31 -31
-31 -31 -31 -31 -31 -31 -31 -31 0 0 0 0 0 100 100 100 0 0 2 -31 -31 -31 -31 -31 -31
-31 -31 -31 -31 -31 -31 -31 -31 17 0 0 0 0 0 0 0 0 0 22 45 -31 -31 -31 -31 -31
-31 -31 -31 -31 -31 -31 -31 -31 -31 4 0 0 0 0 0 0 0 0 0 42 -31 -31 -31 -31 -31
-31 -31 -31 -31 -31 -31 -31 -31 -31 -31 -31 0 0 0 0 0 0 0 -31 -31 -31 -31 -31 -31 -31
-31 -31 -31 -31 -31 -31 -31 -31 -31 -31 -31 -31 12 1 0 2 0 1 -31 -31 -31 -31 -31 -31 -31
-31 -31 -31 -31 -31 -31 -31 -31 -31 -31 -31 -31 -31 -31 -31 -31 -31 -31 -31 -31 -31 -31 -31 -31 -31
-31 -31 -31 -31 -31 -31 -31 -31 -31 -31 -31 -31 -31 -31 -31 -31 -31 -31 -31 -31 -31 -31 -31 -31 -31
-31 -31 -31 -31 -31 -31 -31 -31 -31 -31 -31 -31 -31 -31 -31 -31 -31 -31 -31 -31 -31 -31 -31 -31 -31
-31 -31 -31 -31 -31 -31 -31 -31 -31 -31 -31 -31 -31 -31 -31 -31 -31 -31 -31 -31 -31 -31 -31 -31 -31
-31 -31 -31 -31 -31 -31 -31 -31 -31 -31 -31 -31 -31 -31 -31 -31 -31 -31 -31 -31 -31 -31 -31 -31 -31
-31 -31 -31 -31 -31 -31 -31 -31 -31 -31 -31 -31 -31 -31 -31 -31 -31 -31 -31 -31 -31 -31 -31 -31 -31
-31 -31 -31 -31 -31 -31 -31 -31 -31 -31 -31 -31 -31 -31 -31 -31 -31 -31 -31 -31 -31 -31 -31 -31 -31

RawMap-16-58-16
-31 -31 -31 -31 -31 -31 -31 -31 -31 -31 -31 -31 -31 -31 -31 -31 -31 -31 -31 -31 -31 -31 -31 -31 -31
-31 -31 -31 -31 -31 -31 -31 -31 -31 -31 -31 -31 -31 -31 -31 -31 -31 -31 -31 -31 -31 -31 -31 -31 -31
-31 -31 -31 -31 -31 -31 -31 -31 -31 -31 -31 -31 -31 -31 -31 -31 -31 -31 -31 -31 -31 -31 -31 -31 -31
-31 -31 -31 -31 -31 -31 -31 -31 -31 -31 -31 -31 -31 -31 -31 -31 -31 -31 -31 -31 -31 -31 -31 -31 -31
-31 -31 -31 -31 -31 -31 -31 -31 -31 -31 -31 -31 -31 -31 -31 -31 -31 -31 -31 -31 -31 -31 -31 -31 -31
-31 -31 -31 -31 -31 -31 -31 -31 -31 -31 -31 -31 -31 -31 -31 -31 -31 -31 -31 -31 -31 -31 -31 -31 -31
Failed to read line in map
-31 -31 -31 -31 -31 -31 -31 -31 -31 -31 -31 -31 -31 -31 -31 -31 -31 -31 -31 -31 -31 -31 -31 -31 -31
-31 -31 -31 -31 -31 -31 -31 -31 -31 -31 12 0 0 0 -31 -31 -31 -31 -31 -31 -31 -31 -31 -31 -31
-31 -31 -31 -31 -31 -31 -31 -31 -31 0 0 0 0 0 0 0 -31 -31 -31 -31 -31 -31 -31 -31 -31
-31 -31 -31 -31 -31 -31 -31 -31 4 0 0 0 0 0 0 0 0 -31 -31 -31 -31 -31 -31 -31 -31
-31 -31 -31 -31 -31 -31 -31 -31 0 0 0 0 0 0 0 0 0 0 0 17 -31 -31 -31 -31 -31
-31 -31 -31 -31 -31 -31 -31 -31 0 0 0 0 100 100 0 0 0 0 0 4 -31 -31 -31 -31 -31
-31 -31 -31 -31 -31 -31 -31 -31 0 0 0 0 0 100 100 100 0 29 54 -31 -31 -31 -31 -31 -31
-31 -31 -31 -31 -31 -31 -31 -31 17 0 0 0 0 0 0 0 0 21 54 45 -31 -31 -31 -31 -31
-31 -31 -31 -31 -31 -31 -31 -31 -31 4 0 0 0 0 0 0 0 0 0 42 -31 -31 -31 -31 -31
-31 -31 -31 -31 -31 -31 -31 -31 -31 -31 -31 0 0 0 0 0 0 0 9 -31 -31 -31 -31 -31 -31
-31 -31 -31 -31 -31 -31 -31 -31 -31 -31 -31 -31 12 1 0 0 0 0 23 -31 -31 -31 -31 -31 -31
-31 -31 -31 -31 -31 -31 -31 -31 -31 -31 -31 -31 -31 -31 -31 -31 -31 -31 -31 -31 -31 -31 -31 -31 -31
-31 -31 -31 -31 -31 -31 -31 -31 -31 -31 -31 -31 -31 -31 -31 -31 -31 -31 -31 -31 -31 -31 -31 -31 -31
-31 -31 -31 -31 -31 -31 -31 -31 -31 -31 -31 -31 -31 -31 -31 -31 -31 -31 -31 -31 -31 -31 -31 -31 -31
-31 -31 -31 -31 -31 -31 -31 -31 -31 -31 -31 -31 -31 -31 -31 -31 -31 -31 -31 -31 -31 -31 -31 -31 -31
-31 -31 -31 -31 -31 -31 -31 -31 -31 -31 -31 -31 -31 -31 -31 -31 -31 -31 -31 -31 -31 -31 -31 -31 -31
-31 -31 -31 -31 -31 -31 -31 -31 -31 -31 -31 -31 -31 -31 -31 -31 -31 -31 -31 -31 -31 -31 -31 -31 -31
-31 -31 -31 -31 -31 -31 -31 -31 -31 -31 -31 -31 -31 -31 -31 -31 -31 -31 -31 -31 -31 -31 -31 -31 -31

RawMap-16-58-26
-31 -31 -31 -31 -31 -31 -31 -31 -31 -31 -31 -31 -31 -31 -31 -31 -31 -31 -31 -31 -31 -31 -31 -31 -31
-31 -31 -31 -31 -31 -31 -31 -31 -31 -31 -31 -31 -31 -31 -31 -31 -31 -31 -31 -31 -31 -31 -31 -31 -31
-31 -31 -31 -31 -31 -31 -31 -31 -31 -31 -31 -31 -31 -31 -31 -31 -31 -31 -31 -31 -31 -31 -31 -31 -31
-31 -31 -31 -31 -31 -31 -31 -31 -31 -31 -31 -31 -31 -31 -31 -31 -31 -31 -31 -31 -31 -31 -31 -31 -31
-31 -31 -31 -31 -31 -31 -31 -31 -31 -31 -31 -31 -31 -31 -31 -31 -31 -31 -31 -31 -31 -31 -31 -31 -31
-31 -31 -31 -31 -31 -31 -31 -31 -31 -31 -31 -31 -31 -31 -31 -31 -31 -31 -31 -31 -31 -31 -31 -31 -31
-31 -31 -31 -31 -31 -31 -31 -31 -31 -31 -31 -31 -31 -31 -31 -31 -31 -31 -31 -31 -31 -31 -31 -31 -31
-31 -31 -31 -31 -31 -31 -31 -31 -31 -31 -31 -31 -31 -31 -31 1 0 0 9 -31 -31 -31 -31 -31 -31
-31 -31 -31 -31 -31 -31 -31 -31 -31 -31 12 0 0 0 0 0 0 0 0 0 -31 -31 -31 -31 -31
-31 -31 -31 -31 -31 -31 -31 -31 -31 0 0 0 0 0 0 0 0 0 0 0 12 -31 -31 -31 -31
-31 -31 -31 -31 -31 -31 -31 -31 4 0 0 0 0 0 0 0 0 0 0 0 0 -31 -31 -31 -31
-31 -31 -31 -31 -31 -31 -31 -31 0 0 0 0 0 0 0 0 100 0 0 0 0 -31 -31 -31 -31
-31 -31 -31 -31 -31 -31 -31 -31 0 0 0 0 100 100 100 100 0 0 0 0 9 -31 -31 -31 -31
-31 -31 -31 -31 -31 -31 -31 -31 0 0 0 0 0 100 100 100 0 0 0 -31 -31 -31 -31 -31 -31
-31 -31 -31 -31 -31 -31 -31 -31 17 0 0 0 0 0 0 0 0 2 54 45 -31 -31 -31 -31 -31
-31 -31 -31 -31 -31 -31 -31 -31 -31 4 0 0 0 0 0 0 0 0 0 42 -31 -31 -31 -31 -31
-31 -31 -31 -31 -31 -31 -31 -31 -31 -31 -31 0 0 0 0 0 0 0 9 -31 -31 -31 -31 -31 -31
-31 -31 -31 -31 -31 -31 -31 -31 -31 -31 -31 -31 12 1 0 0 0 0 23 -31 -31 -31 -31 -31 -31
-31 -31 -31 -31 -31 -31 -31 -31 -31 -31 -31 -31 -31 -31 -31 -31 -31 -31 -31 -31 -31 -31 -31 -31 -31
-31 -31 -31 -31 -31 -31 -31 -31 -31 -31 -31 -31 -31 -31 -31 -31 -31 -31 -31 -31 -31 -31 -31 -31 -31
-31 -31 -31 -31 -31 -31 -31 -31 -31 -31 -31 -31 -31 -31 -31 -31 -31 -31 -31 -31 -31 -31 -31 -31 -31
-31 -31 -31 -31 -31 -31 -31 -31 -31 -31 -31 -31 -31 -31 -31 -31 -31 -31 -31 -31 -31 -31 -31 -31 -31
-31 -31 -31 -31 -31 -31 -31 -31 -31 -31 -31 -31 -31 -31 -31 -31 -31 -31 -31 -31 -31 -31 -31 -31 -31
-31 -31 -31 -31 -31 -31 -31 -31 -31 -31 -31 -31 -31 -31 -31 -31 -31 -31 -31 -31 -31 -31 -31 -31 -31
-31 -31 -31 -31 -31 -31 -31 -31 -31 -31 -31 -31 -31 -31 -31 -31 -31 -31 -31 -31 -31 -31 -31 -31 -31

RawMap-16-58-36
-31 -31 -31 -31 -31 -31 -31 -31 -31 -31 -31 -31 -31 -31 -31 -31 -31 -31 -31 -31 -31 -31 -31 -31 -31
-31 -31 -31 -31 -31 -31 -31 -31 -31 -31 -31 -31 -31 -31 -31 -31 -31 -31 -31 -31 -31 -31 -31 -31 -31
-31 -31 -31 -31 -31 -31 -31 -31 -31 -31 -31 -31 -31 -31 -31 -31 -31 -31 -31 -31 -31 -31 -31 -31 -31
-31 -31 -31 -31 -31 -31 -31 -31 -31 -31 -31 -31 -31 -31 -31 -31 -31 -31 -31 -31 -31 -31 -31 -31 -31
-31 -31 -31 -31 -31 -31 -31 -31 -31 -31 -31 -31 -31 -31 -31 -31 -31 -31 -31 -31 -31 -31 -31 -31 -31
-31 -31 -31 -31 -31 -31 -31 -31 -31 -31 -31 -31 -31 -31 -31 -31 -31 -31 -31 -31 -31 -31 -31 -31 -31
-31 -31 -31 -31 -31 -31 -31 -31 -31 -31 -31 -31 -31 -31 -31 -31 -31 -31 -31 -31 -31 -31 -31 -31 -31
-31 -31 -31 -31 -31 -31 -31 -31 -31 -31 -31 -31 -31 -31 -31 0 0 0 0 -31 -31 -31 -31 -31 -31
-31 -31 -31 -31 -31 -31 -31 -31 -31 -31 12 0 0 0 0 0 0 0 0 0 -31 -31 -31 -31 -31
-31 -31 -31 -31 -31 -31 -31 -31 -31 0 0 0 0 0 0 0 0 0 0 0 0 -31 -31 -31 -31
-31 -31 -31 -31 -31 -31 -31 -31 4 0 0 0 0 0 0 0 0 0 0 0 0 -31 -31 -31 -31
-31 -31 -31 -31 -31 -31 -31 -31 0 0 0 0 0 0 0 0 100 0 0 0 0 -31 -31 -31 -31
-31 -31 -31 -31 -31 -31 -31 -31 0 0 0 0 100 100 100 100 0 0 0 0 0 -31 -31 -31 -31
-31 -31 -31 -31 -31 -31 -31 -31 0 0 0 0 0 100 100 100 0 0 0 0 9 -31 -31 -31 -31
-31 -31 -31 -31 -31 -31 -31 -31 17 0 0 0 0 0 0 0 0 0 0 6 -31 -31 -31 -31 -31
-31 -31 -31 -31 -31 -31 -31 -31 -31 4 0 0 0 0 0 0 0 0 0 42 -31 -31 -31 -31 -31
-31 -31 -31 -31 -31 -31 -31 -31 -31 -31 -31 0 0 0 0 0 0 0 9 -31 -31 -31 -31 -31 -31
-31 -31 -31 -31 -31 -31 -31 -31 -31 -31 -31 -31 12 1 0 0 0 0 23 -31 -31 -31 -31 -31 -31
-31 -31 -31 -31 -31 -31 -31 -31 -31 -31 -31 -31 -31 -31 -31 -31 -31 -31 -31 -31 -31 -31 -31 -31 -31
-31 -31 -31 -31 -31 -31 -31 -31 -31 -31 -31 -31 -31 -31 -31 -31 -31 -31 -31 -31 -31 -31 -31 -31 -31
-31 -31 -31 -31 -31 -31 -31 -31 -31 -31 -31 -31 -31 -31 -31 -31 -31 -31 -31 -31 -31 -31 -31 -31 -31
-31 -31 -31 -31 -31 -31 -31 -31 -31 -31 -31 -31 -31 -31 -31 -31 -31 -31 -31 -31 -31 -31 -31 -31 -31
-31 -31 -31 -31 -31 -31 -31 -31 -31 -31 -31 -31 -31 -31 -31 -31 -31 -31 -31 -31 -31 -31 -31 -31 -31
-31 -31 -31 -31 -31 -31 -31 -31 -31 -31 -31 -31 -31 -31 -31 -31 -31 -31 -31 -31 -31 -31 -31 -31 -31
-31 -31 -31 -31 -31 -31 -31 -31 -31 -31 -31 -31 -31 -31 -31 -31 -31 -31 -31 -31 -31 -31 -31 -31 -31

RawMap-16-58-46
-31 -31 -31 -31 -31 -31 -31 -31 -31 -31 -31 -31 -31 -31 -31 -31 -31 -31 -31 -31 -31 -31 -31 -31 -31
-31 -31 -31 -31 -31 -31 -31 -31 -31 -31 -31 -31 -31 -31 -31 -31 -31 -31 -31 -31 -31 -31 -31 -31 -31
-31 -31 -31 -31 -31 -31 -31 -31 -31 -31 -31 -31 -31 -31 -31 -31 -31 -31 -31 -31 -31 -31 -31 -31 -31
-31 -31 -31 -31 -31 -31 -31 -31 -31 -31 -31 -31 -31 -31 -31 -31 -31 -31 -31 -31 -31 -31 -31 -31 -31
-31 -31 -31 -31 -31 -31 -31 -31 -31 -31 -31 -31 -31 -31 -31 -31 -31 -31 -31 -31 -31 -31 -31 -31 -31
-31 -31 -31 -31 -31 -31 -31 -31 -31 -31 -31 -31 -31 -31 -31 -31 -31 -31 -31 -31 -31 -31 -31 -31 -31
-31 -31 -31 -31 -31 -31 -31 -31 -31 -31 -31 -31 -31 -31 -31 -31 -31 -31 -31 -31 -31 -31 -31 -31 -31
-31 -31 -31 -31 -31 -31 -31 -31 -31 -31 -31 -31 -31 -31 23 0 0 0 0 23 -31 -31 -31 -31 -31
-31 -31 -31 -31 -31 -31 -31 -31 -31 -31 12 0 0 0 0 0 0 0 0 0 -31 -31 -31 -31 -31
-31 -31 -31 -31 -31 -31 -31 -31 -31 0 0 0 0 0 0 0 0 0 0 0 0 -31 -31 -31 -31
-31 -31 -31 -31 -31 -31 -31 -31 4 0 0 0 0 0 0 0 0 0 0 0 0 -31 -31 -31 -31
-31 -31 -31 -31 -31 -31 -31 -31 0 0 0 0 0 0 0 0 100 0 0 0 0 -31 -31 -31 -31
-31 -31 -31 -31 -31 -31 -31 -31 0 0 0 0 100 100 100 100 0 0 0 0 0 -31 -31 -31 -31
-31 -31 -31 -31 -31 -31 -31 -31 0 0 0 0 0 100 100 100 0 0 0 0 3 -31 -31 -31 -31
-31 -31 -31 -31 -31 -31 -31 -31 17 0 0 0 0 0 0 0 0 0 0 0 -31 -31 -31 -31 -31
-31 -31 -31 -31 -31 -31 -31 -31 -31 4 0 0 0 0 0 0 0 0 0 42 -31 -31 -31 -31 -31
-31 -31 -31 -31 -31 -31 -31 -31 -31 -31 -31 0 0 0 0 0 0 0 9 -31 -31 -31 -31 -31 -31
-31 -31 -31 -31 -31 -31 -31 -31 -31 -31 -31 -31 12 1 0 0 0 0 23 -31 -31 -31 -31 -31 -31
-31 -31 -31 -31 -31 -31 -31 -31 -31 -31 -31 -31 -31 -31 -31 -31 -31 -31 -31 -31 -31 -31 -31 -31 -31
-31 -31 -31 -31 -31 -31 -31 -31 -31 -31 -31 -31 -31 -31 -31 -31 -31 -31 -31 -31 -31 -31 -31 -31 -31
-31 -31 -31 -31 -31 -31 -31 -31 -31 -31 -31 -31 -31 -31 -31 -31 -31 -31 -31 -31 -31 -31 -31 -31 -31
-31 -31 -31 -31 -31 -31 -31 -31 -31 -31 -31 -31 -31 -31 -31 -31 -31 -31 -31 -31 -31 -31 -31 -31 -31
-31 -31 -31 -31 -31 -31 -31 -31 -31 -31 -31 -31 -31 -31 -31 -31 -31 -31 -31 -31 -31 -31 -31 -31 -31
-31 -31 -31 -31 -31 -31 -31 -31 -31 -31 -31 -31 -31 -31 -31 -31 -31 -31 -31 -31 -31 -31 -31 -31 -31
-31 -31 -31 -31 -31 -31 -31 -31 -31 -31 -31 -31 -31 -31 -31 -31 -31 -31 -31 -31 -31 -31 -31 -31 -31

RawMap-16-58-56
-31 -31 -31 -31 -31 -31 -31 -31 -31 -31 -31 -31 -31 -31 -31 -31 -31 -31 -31 -31 -31 -31 -31 -31 -31
-31 -31 -31 -31 -31 -31 -31 -31 -31 -31 -31 -31 -31 -31 -31 -31 -31 -31 -31 -31 -31 -31 -31 -31 -31
-31 -31 -31 -31 -31 -31 -31 -31 -31 -31 -31 -31 -31 -31 -31 -31 -31 -31 -31 -31 -31 -31 -31 -31 -31
-31 -31 -31 -31 -31 -31 -31 -31 -31 -31 -31 -31 -31 -31 -31 -31 -31 -31 -31 -31 -31 -31 -31 -31 -31
-31 -31 -31 -31 -31 -31 -31 -31 -31 -31 -31 -31 -31 -31 -31 -31 -31 -31 -31 -31 -31 -31 -31 -31 -31
-31 -31 -31 -31 -31 -31 -31 -31 -31 -31 -31 -31 -31 -31 -31 -31 -31 -31 -31 -31 -31 -31 -31 -31 -31
-31 -31 -31 -31 -31 -31 -31 -31 -31 -31 -31 -31 -31 -31 -31 -31 -31 -31 -31 -31 -31 -31 -31 -31 -31
-31 -31 -31 -31 -31 -31 -31 -31 -31 -31 -31 -31 -31 -31 23 0 0 0 0 23 -31 -31 -31 -31 -31
-31 -31 -31 -31 -31 -31 -31 -31 -31 -31 12 0 0 0 0 0 0 0 0 0 17 -31 -31 -31 -31
-31 -31 -31 -31 -31 -31 -31 -31 -31 0 0 0 0 0 0 0 0 0 0 0 0 -31 -31 -31 -31
-31 -31 -31 -31 -31 -31 -31 -31 4 0 0 0 0 0 0 0 0 0 0 0 0 -31 -31 -31 -31
-31 -31 -31 -31 -31 -31 -31 -31 0 0 0 0 0 0 0 0 100 100 0 0 0 -31 -31 -31 -31
-31 -31 -31 -31 -31 -31 -31 -31 0 0 0 0 100 100 100 100 0 0 0 0 0 -31 -31 -31 -31
-31 -31 -31 -31 -31 -31 -31 -31 0 0 0 0 0 100 100 100 0 0 0 0 0 -31 -31 -31 -31
-31 -31 -31 -31 -31 -31 -31 -31 17 0 0 0 0 0 0 0 0 0 0 0 -31 -31 -31 -31 -31
-31 -31 -31 -31 -31 -31 -31 -31 -31 4 0 0 0 0 0 0 0 0 0 42 -31 -31 -31 -31 -31
-31 -31 -31 -31 -31 -31 -31 -31 -31 -31 -31 0 0 0 0 0 0 0 9 -31 -31 -31 -31 -31 -31
-31 -31 -31 -31 -31 -31 -31 -31 -31 -31 -31 -31 12 1 0 0 0 0 23 -31 -31 -31 -31 -31 -31
-31 -31 -31 -31 -31 -31 -31 -31 -31 -31 -31 -31 -31 -31 -31 -31 -31 -31 -31 -31 -31 -31 -31 -31 -31
-31 -31 -31 -31 -31 -31 -31 -31 -31 -31 -31 -31 -31 -31 -31 -31 -31 -31 -31 -31 -31 -31 -31 -31 -31
-31 -31 -31 -31 -31 -31 -31 -31 -31 -31 -31 -31 -31 -31 -31 -31 -31 -31 -31 -31 -31 -31 -31 -31 -31
-31 -31 -31 -31 -31 -31 -31 -31 -31 -31 -31 -31 -31 -31 -31 -31 -31 -31 -31 -31 -31 -31 -31 -31 -31
-31 -31 -31 -31 -31 -31 -31 -31 -31 -31 -31 -31 -31 -31 -31 -31 -31 -31 -31 -31 -31 -31 -31 -31 -31
-31 -31 -31 -31 -31 -31 -31 -31 -31 -31 -31 -31 -31 -31 -31 -31 -31 -31 -31 -31 -31 -31 -31 -31 -31
-31 -31 -31 -31 -31 -31 -31 -31 -31 -31 -31 -31 -31 -31 -31 -31 -31 -31 -31 -31 -31 -31 -31 -31 -31

RawMap-16-59-06
-31 -31 -31 -31 -31 -31 -31 -31 -31 -31 -31 -31 -31 -31 -31 -31 -31 -31 -31 -31 -31 -31 -31 -31 -31
-31 -31 -31 -31 -31 -31 -31 -31 -31 -31 -31 -31 -31 -31 -31 -31 -31 -31 -31 -31 -31 -31 -31 -31 -31
-31 -31 -31 -31 -31 -31 -31 -31 -31 -31 -31 -31 -31 -31 -31 -31 -31 -31 -31 -31 -31 -31 -31 -31 -31
-31 -31 -31 -31 -31 -31 -31 -31 -31 -31 -31 -31 -31 -31 -31 -31 -31 -31 -31 -31 -31 -31 -31 -31 -31
-31 -31 -31 -31 -31 -31 -31 -31 -31 -31 -31 -31 -31 -31 -31 -31 -31 -31 -31 -31 -31 -31 -31 -31 -31
-31 -31 -31 -31 -31 -31 -31 -31 -31 -31 -31 -31 -31 -31 -31 -31 -31 -31 -31 -31 -31 -31 -31 -31 -31
-31 -31 -31 -31 -31 -31 -31 -31 -31 -31 -31 -31 -31 -31 -31 -31 -31 -31 -31 -31 -31 -31 -31 -31 -31
-31 -31 -31 -31 -31 -31 -31 -31 -31 -31 -31 -31 -31 -31 17 0 0 0 0 12 -31 -31 -31 -31 -31
-31 -31 -31 -31 -31 -31 -31 -31 -31 -31 12 0 0 0 0 0 0 0 0 0 9 -31 -31 -31 -31
-31 -31 -31 -31 -31 -31 -31 -31 -31 0 0 0 0 0 0 0 0 0 0 0 0 -31 -31 -31 -31
-31 -31 -31 -31 -31 -31 -31 -31 4 0 0 0 0 0 0 0 0 0 0 0 0 -31 -31 -31 -31
-31 -31 -31 -31 -31 -31 -31 -31 0 0 0 0 0 0 0 0 100 100 0 0 0 -31 -31 -31 -31
-31 -31 -31 -31 -31 -31 -31 -31 0 0 0 0 100 100 100 100 0 0 0 0 0 -31 -31 -31 -31
-31 -31 -31 -31 -31 -31 -31 -31 0 0 0 0 0 100 100 100 0 0 0 0 0 -31 -31 -31 -31
-31 -31 -31 -31 -31 -31 -31 -31 17 0 0 0 0 0 0 0 0 0 0 0 -31 -31 -31 -31 -31
-31 -31 -31 -31 -31 -31 -31 -31 -31 4 0 0 0 0 0 0 0 0 0 42 -31 -31 -31 -31 -31
-31 -31 -31 -31 -31 -31 -31 -31 -31 -31 -31 0 0 0 0 0 0 0 9 -31 -31 -31 -31 -31 -31
-31 -31 -31 -31 -31 -31 -31 -31 -31 -31 -31 -31 12 1 0 0 0 0 23 -31 -31 -31 -31 -31 -31
-31 -31 -31 -31 -31 -31 -31 -31 -31 -31 -31 -31 -31 -31 -31 -31 -31 -31 -31 -31 -31 -31 -31 -31 -31
-31 -31 -31 -31 -31 -31 -31 -31 -31 -31 -31 -31 -31 -31 -31 -31 -31 -31 -31 -31 -31 -31 -31 -31 -31
-31 -31 -31 -31 -31 -31 -31 -31 -31 -31 -31 -31 -31 -31 -31 -31 -31 -31 -31 -31 -31 -31 -31 -31 -31
-31 -31 -31 -31 -31 -31 -31 -31 -31 -31 -31 -31 -31 -31 -31 -31 -31 -31 -31 -31 -31 -31 -31 -31 -31
-31 -31 -31 -31 -31 -31 -31 -31 -31 -31 -31 -31 -31 -31 -31 -31 -31 -31 -31 -31 -31 -31 -31 -31 -31
-31 -31 -31 -31 -31 -31 -31 -31 -31 -31 -31 -31 -31 -31 -31 -31 -31 -31 -31 -31 -31 -31 -31 -31 -31
-31 -31 -31 -31 -31 -31 -31 -31 -31 -31 -31 -31 -31 -31 -31 -31 -31 -31 -31 -31 -31 -31 -31 -31 -31

RawMap-16-59-18
-31 -31 -31 -31 -31 -31 -31 -31 -31 -31 -31 -31 -31 -31 -31 -31 -31 -31 -31 -31 -31 -31 -31 -31 -31
-31 -31 -31 -31 -31 -31 -31 -31 -31 -31 -31 -31 -31 -31 -31 -31 -31 -31 -31 -31 -31 -31 -31 -31 -31
-31 -31 -31 -31 -31 -31 -31 -31 -31 -31 -31 -31 -31 -31 -31 -31 -31 -31 -31 -31 -31 -31 -31 -31 -31
-31 -31 -31 -31 -31 -31 -31 -31 -31 -31 -31 -31 -31 -31 -31 -31 -31 -31 -31 -31 -31 -31 -31 -31 -31
-31 -31 -31 -31 -31 -31 -31 -31 -31 -31 -31 -31 -31 -31 -31 -31 -31 -31 -31 -31 -31 -31 -31 -31 -31
-31 -31 -31 -31 -31 -31 -31 -31 -31 -31 -31 -31 -31 -31 -31 -31 -31 -31 -31 -31 -31 -31 -31 -31 -31
-31 -31 -31 -31 -31 -31 -31 -31 -31 -31 -31 -31 -31 -31 -31 -31 -31 -31 -31 -31 -31 -31 -31 -31 -31
-31 -31 -31 -31 -31 -31 -31 -31 -31 -31 -31 -31 -31 -31 6 0 0 0 0 3 -31 -31 -31 -31 -31
-31 -31 -31 -31 -31 -31 -31 -31 -31 -31 12 0 0 0 0 0 0 0 0 0 2 -31 -31 -31 -31
-31 -31 -31 -31 -31 -31 -31 -31 -31 0 0 0 0 0 0 0 0 0 0 0 0 -31 -31 -31 -31
-31 -31 -31 -31 -31 -31 -31 -31 4 0 0 0 0 0 0 0 0 0 0 0 0 -31 -31 -31 -31
-31 -31 -31 -31 -31 -31 -31 -31 0 0 0 0 0 0 0 0 100 100 0 0 0 -31 -31 -31 -31
-31 -31 -31 -31 -31 -31 -31 -31 0 0 0 0 100 100 100 100 0 0 0 0 0 -31 -31 -31 -31
-31 -31 -31 -31 -31 -31 -31 -31 0 0 0 0 0 100 100 100 0 0 0 0 0 -31 -31 -31 -31
-31 -31 -31 -31 -31 -31 -31 -31 17 0 0 0 0 0 0 0 0 0 0 0 -31 -31 -31 -31 -31
-31 -31 -31 -31 -31 -31 -31 -31 -31 4 0 0 0 0 0 0 0 0 0 42 -31 -31 -31 -31 -31
-31 -31 -31 -31 -31 -31 -31 -31 -31 -31 -31 0 0 0 0 0 0 0 9 -31 -31 -31 -31 -31 -31
-31 -31 -31 -31 -31 -31 -31 -31 -31 -31 -31 -31 12 1 0 0 0 0 23 -31 -31 -31 -31 -31 -31
-31 -31 -31 -31 -31 -31 -31 -31 -31 -31 -31 -31 -31 -31 -31 -31 -31 -31 -31 -31 -31 -31 -31 -31 -31
-31 -31 -31 -31 -31 -31 -31 -31 -31 -31 -31 -31 -31 -31 -31 -31 -31 -31 -31 -31 -31 -31 -31 -31 -31
-31 -31 -31 -31 -31 -31 -31 -31 -31 -31 -31 -31 -31 -31 -31 -31 -31 -31 -31 -31 -31 -31 -31 -31 -31
-31 -31 -31 -31 -31 -31 -31 -31 -31 -31 -31 -31 -31 -31 -31 -31 -31 -31 -31 -31 -31 -31 -31 -31 -31
-31 -31 -31 -31 -31 -31 -31 -31 -31 -31 -31 -31 -31 -31 -31 -31 -31 -31 -31 -31 -31 -31 -31 -31 -31
-31 -31 -31 -31 -31 -31 -31 -31 -31 -31 -31 -31 -31 -31 -31 -31 -31 -31 -31 -31 -31 -31 -31 -31 -31
-31 -31 -31 -31 -31 -31 -31 -31 -31 -31 -31 -31 -31 -31 -31 -31 -31 -31 -31 -31 -31 -31 -31 -31 -31

RawMap-16-59-28
-31 -31 -31 -31 -31 -31 -31 -31 -31 -31 -31 -31 -31 -31 -31 -31 -31 -31 -31 -31 -31 -31 -31 -31 -31
-31 -31 -31 -31 -31 -31 -31 -31 -31 -31 -31 -31 -31 -31 -31 -31 -31 -31 -31 -31 -31 -31 -31 -31 -31
-31 -31 -31 -31 -31 -31 -31 -31 -31 -31 -31 -31 -31 -31 -31 -31 -31 -31 -31 -31 -31 -31 -31 -31 -31
-31 -31 -31 -31 -31 -31 -31 -31 -31 -31 -31 -31 -31 -31 -31 -31 -31 -31 -31 -31 -31 -31 -31 -31 -31
-31 -31 -31 -31 -31 -31 -31 -31 -31 -31 -31 -31 -31 -31 -31 -31 -31 -31 -31 -31 -31 -31 -31 -31 -31
-31 -31 -31 -31 -31 -31 -31 -31 -31 -31 -31 -31 -31 -31 -31 -31 -31 -31 -31 -31 -31 -31 -31 -31 -31
-31 -31 -31 -31 -31 -31 -31 -31 -31 -31 -31 -31 -31 -31 -31 -31 -31 -31 -31 -31 -31 -31 -31 -31 -31
-31 -31 -31 -31 -31 -31 -31 -31 -31 -31 -31 -31 -31 -31 0 0 0 0 0 0 -31 -31 -31 -31 -31
-31 -31 -31 -31 -31 -31 -31 -31 -31 -31 12 0 0 0 0 0 0 0 0 0 0 -31 -31 -31 -31
-31 -31 -31 -31 -31 -31 -31 -31 -31 0 0 0 0 0 0 0 0 0 0 0 0 -31 -31 -31 -31
-31 -31 -31 -31 -31 -31 -31 -31 4 0 0 0 0 0 0 0 0 100 0 0 0 -31 -31 -31 -31
-31 -31 -31 -31 -31 -31 -31 -31 0 0 0 0 0 0 0 0 100 100 0 0 0 -31 -31 -31 -31
-31 -31 -31 -31 -31 -31 -31 -31 0 0 0 0 100 100 100 100 0 0 0 0 0 -31 -31 -31 -31
-31 -31 -31 -31 -31 -31 -31 -31 0 0 0 0 0 100 100 100 0 0 0 0 0 -31 -31 -31 -31
-31 -31 -31 -31 -31 -31 -31 -31 17 0 0 0 0 0 0 0 0 0 0 0 -31 -31 -31 -31 -31
-31 -31 -31 -31 -31 -31 -31 -31 -31 4 0 0 0 0 0 0 0 0 0 42 -31 -31 -31 -31 -31
-31 -31 -31 -31 -31 -31 -31 -31 -31 -31 -31 0 0 0 0 0 0 0 9 -31 -31 -31 -31 -31 -31
-31 -31 -31 -31 -31 -31 -31 -31 -31 -31 -31 -31 12 1 0 0 0 0 23 -31 -31 -31 -31 -31 -31
-31 -31 -31 -31 -31 -31 -31 -31 -31 -31 -31 -31 -31 -31 -31 -31 -31 -31 -31 -31 -31 -31 -31 -31 -31
-31 -31 -31 -31 -31 -31 -31 -31 -31 -31 -31 -31 -31 -31 -31 -31 -31 -31 -31 -31 -31 -31 -31 -31 -31
-31 -31 -31 -31 -31 -31 -31 -31 -31 -31 -31 -31 -31 -31 -31 -31 -31 -31 -31 -31 -31 -31 -31 -31 -31
-31 -31 -31 -31 -31 -31 -31 -31 -31 -31 -31 -31 -31 -31 -31 -31 -31 -31 -31 -31 -31 -31 -31 -31 -31
-31 -31 -31 -31 -31 -31 -31 -31 -31 -31 -31 -31 -31 -31 -31 -31 -31 -31 -31 -31 -31 -31 -31 -31 -31
-31 -31 -31 -31 -31 -31 -31 -31 -31 -31 -31 -31 -31 -31 -31 -31 -31 -31 -31 -31 -31 -31 -31 -31 -31
-31 -31 -31 -31 -31 -31 -31 -31 -31 -31 -31 -31 -31 -31 -31 -31 -31 -31 -31 -31 -31 -31 -31 -31 -31

