RawMap-11-43-30
-31 -31 -31 -31 -31 -31 -31 -31 -31 -31 -31 -31 -31 -31 -31 -31 -31 -31 -31 -31 -31 -31 -31 -31 -31
-31 -31 -31 -31 -31 -31 -31 -31 -31 -31 -31 -31 -31 -31 -31 -31 -31 -31 -31 -31 -31 -31 -31 -31 -31
-31 -31 -31 -31 -31 -31 -31 -31 -31 -31 -31 -31 -31 -31 -31 -31 -31 -31 -31 -31 -31 -31 -31 -31 -31
-31 -31 -31 -31 -31 -31 -31 -31 -31 -31 -31 -31 -31 -31 -31 -31 -31 -31 -31 -31 -31 -31 -31 -31 -31
-31 -31 -31 -31 -31 -31 -31 -31 -31 -31 -31 -31 -31 -31 -31 -31 -31 -31 -31 -31 -31 -31 -31 -31 -31
-31 -31 -31 -31 -31 -31 -31 -31 -31 -31 -31 -31 -31 -31 -31 -31 -31 -31 -31 -31 -31 -31 -31 -31 -31
-31 -31 -31 -31 -31 -31 -31 -31 -31 -31 -31 -31 -31 -31 -31 -31 -31 -31 -31 -31 -31 -31 -31 -31 -31
-31 -31 -31 -31 -31 -31 -31 -31 -31 -31 -31 -31 -31 -31 -31 -31 -31 -31 -31 -31 -31 -31 -31 -31 -31
-31 -31 -31 -31 -31 -31 -31 -31 -31 -31 -31 -31 -31 -31 -31 -31 -31 -31 46 56 -31 -31 -31 -31 -31
-31 -31 -31 -31 -31 -31 -31 -31 -31 -31 -31 -31 -31 -31 -31 19 0 0 18 46 -31 -31 -31 -31 -31
-31 -31 -31 -31 -31 -31 -31 -31 -31 -31 -31 -31 -31 -31 13 0 0 0 0 49 46 -31 -31 -31 -31
-31 -31 -31 -31 -31 -31 -31 -31 -31 -31 -31 -31 -31 0 0 0 0 0 0 37 48 51 -31 -31 -31
-31 -31 -31 -31 -31 -31 -31 -31 -31 -31 -31 -31 100 100 100 100 100 0 0 0 0 0 -31 -31 -31
-31 -31 -31 -31 -31 -31 -31 -31 -31 -31 -31 -31 21 0 0 100 100 100 0 0 0 1 -31 -31 -31
-31 -31 -31 -31 -31 -31 -31 -31 -31 -31 -31 -31 -31 21 0 0 0 0 0 0 0 14 -31 -31 -31
-31 -31 -31 -31 -31 -31 -31 -31 -31 -31 -31 -31 -31 -31 40 2 0 0 0 0 0 1 -31 -31 -31
-31 -31 -31 -31 -31 -31 -31 -31 -31 -31 -31 -31 -31 -31 -31 40 0 0 0 0 6 -31 -31 -31 -31
-31 -31 -31 -31 -31 -31 -31 -31 -31 -31 -31 -31 -31 -31 -31 -31 0 0 0 4 -31 -31 -31 -31 -31
-31 -31 -31 -31 -31 -31 -31 -31 -31 -31 -31 -31 -31 -31 -31 -31 -31 -31 -31 -31 -31 -31 -31 -31 -31
-31 -31 -31 -31 -31 -31 -31 -31 -31 -31 -31 -31 -31 -31 -31 -31 -31 -31 -31 -31 -31 -31 -31 -31 -31
-31 -31 -31 -31 -31 -31 -31 -31 -31 -31 -31 -31 -31 -31 -31 -31 -31 -31 -31 -31 -31 -31 -31 -31 -31
-31 -31 -31 -31 -31 -31 -31 -31 -31 -31 -31 -31 -31 -31 -31 -31 -31 -31 -31 -31 -31 -31 -31 -31 -31
-31 -31 -31 -31 -31 -31 -31 -31 -31 -31 -31 -31 -31 -31 -31 -31 -31 -31 -31 -31 -31 -31 -31 -31 -31
-31 -31 -31 -31 -31 -31 -31 -31 -31 -31 -31 -31 -31 -31 -31 -31 -31 -31 -31 -31 -31 -31 -31 -31 -31
-31 -31 -31 -31 -31 -31 -31 -31 -31 -31 -31 -31 -31 -31 -31 -31 -31 -31 -31 -31 -31 -31 -31 -31 -31

RawMap-11-43-35
-31 -31 -31 -31 -31 -31 -31 -31 -31 -31 -31 -31 -31 -31 -31 -31 -31 -31 -31 -31 -31 -31 -31 -31 -31
-31 -31 -31 -31 -31 -31 -31 -31 -31 -31 -31 -31 -31 -31 -31 -31 -31 -31 -31 -31 -31 -31 -31 -31 -31
-31 -31 -31 -31 -31 -31 -31 -31 -31 -31 -31 -31 -31 -31 -31 -31 -31 -31 -31 -31 -31 -31 -31 -31 -31
-31 -31 -31 -31 -31 -31 -31 -31 -31 -31 -31 -31 -31 -31 -31 -31 -31 -31 -31 -31 -31 -31 -31 -31 -31
-31 -31 -31 -31 -31 -31 -31 -31 -31 -31 -31 -31 -31 -31 -31 -31 -31 -31 -31 -31 -31 -31 -31 -31 -31
-31 -31 -31 -31 -31 -31 -31 -31 -31 -31 -31 -31 -31 -31 -31 -31 -31 -31 -31 -31 -31 -31 -31 -31 -31
-31 -31 -31 -31 -31 -31 -31 -31 -31 -31 -31 -31 -31 -31 -31 -31 -31 -31 -31 -31 -31 -31 -31 -31 -31
-31 -31 -31 -31 -31 -31 -31 -31 -31 -31 -31 -31 -31 -31 -31 -31 -31 -31 -31 -31 -31 -31 -31 -31 -31
-31 -31 -31 -31 -31 -31 -31 -31 -31 -31 -31 -31 -31 -31 -31 -31 -31 -31 46 56 -31 -31 -31 -31 -31
-31 -31 -31 -31 -31 -31 -31 -31 -31 -31 -31 -31 -31 -31 -31 19 0 0 18 46 -31 -31 -31 -31 -31
-31 -31 -31 -31 -31 -31 -31 -31 -31 -31 -31 -31 -31 -31 13 0 0 0 0 49 46 -31 -31 -31 -31
-31 -31 -31 -31 -31 -31 -31 -31 -31 -31 -31 -31 -31 0 0 0 0 0 0 37 48 51 -31 -31 -31
-31 -31 -31 -31 -31 -31 -31 -31 -31 -31 -31 -31 100 100 100 100 100 0 0 0 0 0 -31 -31 -31
-31 -31 -31 -31 -31 -31 -31 -31 -31 -31 -31 -31 21 0 0 100 100 100 0 0 0 1 -31 -31 -31
-31 -31 -31 -31 -31 -31 -31 -31 -31 -31 -31 -31 -31 21 0 0 0 0 0 0 0 14 -31 -31 -31
-31 -31 -31 -31 -31 -31 -31 -31 -31 -31 -31 -31 -31 -31 40 2 0 0 0 0 0 1 -31 -31 -31
-31 -31 -31 -31 -31 -31 -31 -31 -31 -31 -31 -31 -31 -31 -31 40 0 0 0 0 6 -31 -31 -31 -31
-31 -31 -31 -31 -31 -31 -31 -31 -31 -31 -31 -31 -31 -31 -31 -31 0 0 0 4 -31 -31 -31 -31 -31
-31 -31 -31 -31 -31 -31 -31 -31 -31 -31 -31 -31 -31 -31 -31 -31 -31 -31 -31 -31 -31 -31 -31 -31 -31
-31 -31 -31 -31 -31 -31 -31 -31 -31 -31 -31 -31 -31 -31 -31 -31 -31 -31 -31 -31 -31 -31 -31 -31 -31
-31 -31 -31 -31 -31 -31 -31 -31 -31 -31 -31 -31 -31 -31 -31 -31 -31 -31 -31 -31 -31 -31 -31 -31 -31
-31 -31 -31 -31 -31 -31 -31 -31 -31 -31 -31 -31 -31 -31 -31 -31 -31 -31 -31 -31 -31 -31 -31 -31 -31
-31 -31 -31 -31 -31 -31 -31 -31 -31 -31 -31 -31 -31 -31 -31 -31 -31 -31 -31 -31 -31 -31 -31 -31 -31
-31 -31 -31 -31 -31 -31 -31 -31 -31 -31 -31 -31 -31 -31 -31 -31 -31 -31 -31 -31 -31 -31 -31 -31 -31
-31 -31 -31 -31 -31 -31 -31 -31 -31 -31 -31 -31 -31 -31 -31 -31 -31 -31 -31 -31 -31 -31 -31 -31 -31

RawMap-11-43-40
-31 -31 -31 -31 -31 -31 -31 -31 -31 -31 -31 -31 -31 -31 -31 -31 -31 -31 -31 -31 -31 -31 -31 -31 -31
-31 -31 -31 -31 -31 -31 -31 -31 -31 -31 -31 -31 -31 -31 -31 -31 -31 -31 -31 -31 -31 -31 -31 -31 -31
-31 -31 -31 -31 -31 -31 -31 -31 -31 -31 -31 -31 -31 -31 -31 -31 -31 -31 -31 -31 -31 -31 -31 -31 -31
-31 -31 -31 -31 -31 -31 -31 -31 -31 -31 -31 -31 -31 -31 -31 -31 -31 -31 -31 -31 -31 -31 -31 -31 -31
-31 -31 -31 -31 -31 -31 -31 -31 -31 -31 -31 -31 -31 -31 -31 -31 -31 -31 -31 -31 -31 -31 -31 -31 -31
-31 -31 -31 -31 -31 -31 -31 -31 -31 -31 -31 -31 -31 -31 -31 -31 -31 -31 -31 -31 -31 -31 -31 -31 -31
-31 -31 -31 -31 -31 -31 -31 -31 -31 -31 -31 -31 -31 -31 -31 -31 -31 -31 -31 -31 -31 -31 -31 -31 -31
-31 -31 -31 -31 -31 -31 -31 -31 -31 -31 -31 -31 -31 -31 -31 -31 -31 -31 -31 -31 -31 -31 -31 -31 -31
-31 -31 -31 -31 -31 -31 -31 -31 -31 -31 -31 -31 -31 -31 -31 -31 -31 -31 46 56 -31 -31 -31 -31 -31
-31 -31 -31 -31 -31 -31 -31 -31 -31 -31 -31 -31 -31 -31 -31 19 0 0 18 46 -31 -31 -31 -31 -31
-31 -31 -31 -31 -31 -31 -31 -31 -31 -31 -31 -31 -31 -31 13 0 0 0 0 49 46 -31 -31 -31 -31
-31 -31 -31 -31 -31 -31 -31 -31 -31 -31 -31 -31 -31 0 0 0 0 0 0 37 48 51 -31 -31 -31
-31 -31 -31 -31 -31 -31 -31 -31 -31 -31 -31 -31 100 100 100 100 100 0 0 0 0 0 -31 -31 -31
-31 -31 -31 -31 -31 -31 -31 -31 -31 -31 -31 -31 21 0 0 100 100 100 0 0 0 1 -31 -31 -31
-31 -31 -31 -31 -31 -31 -31 -31 -31 -31 -31 -31 -31 21 0 0 0 0 0 0 0 14 -31 -31 -31
-31 -31 -31 -31 -31 -31 -31 -31 -31 -31 -31 -31 -31 -31 40 2 0 0 0 0 0 1 -31 -31 -31
-31 -31 -31 -31 -31 -31 -31 -31 -31 -31 -31 -31 -31 -31 -31 40 0 0 0 0 6 -31 -31 -31 -31
-31 -31 -31 -31 -31 -31 -31 -31 -31 -31 -31 -31 -31 -31 -31 -31 0 0 0 4 -31 -31 -31 -31 -31
-31 -31 -31 -31 -31 -31 -31 -31 -31 -31 -31 -31 -31 -31 -31 -31 -31 -31 -31 -31 -31 -31 -31 -31 -31
-31 -31 -31 -31 -31 -31 -31 -31 -31 -31 -31 -31 -31 -31 -31 -31 -31 -31 -31 -31 -31 -31 -31 -31 -31
-31 -31 -31 -31 -31 -31 -31 -31 -31 -31 -31 -31 -31 -31 -31 -31 -31 -31 -31 -31 -31 -31 -31 -31 -31
-31 -31 -31 -31 -31 -31 -31 -31 -31 -31 -31 -31 -31 -31 -31 -31 -31 -31 -31 -31 -31 -31 -31 -31 -31
-31 -31 -31 -31 -31 -31 -31 -31 -31 -31 -31 -31 -31 -31 -31 -31 -31 -31 -31 -31 -31 -31 -31 -31 -31
-31 -31 -31 -31 -31 -31 -31 -31 -31 -31 -31 -31 -31 -31 -31 -31 -31 -31 -31 -31 -31 -31 -31 -31 -31
-31 -31 -31 -31 -31 -31 -31 -31 -31 -31 -31 -31 -31 -31 -31 -31 -31 -31 -31 -31 -31 -31 -31 -31 -31

RawMap-11-43-45
-31 -31 -31 -31 -31 -31 -31 -31 -31 -31 -31 -31 -31 -31 -31 -31 -31 -31 -31 -31 -31 -31 -31 -31 -31
-31 -31 -31 -31 -31 -31 -31 -31 -31 -31 -31 -31 -31 -31 -31 -31 -31 -31 -31 -31 -31 -31 -31 -31 -31
-31 -31 -31 -31 -31 -31 -31 -31 -31 -31 -31 -31 -31 -31 -31 -31 -31 -31 -31 -31 -31 -31 -31 -31 -31
-31 -31 -31 -31 -31 -31 -31 -31 -31 -31 -31 -31 -31 -31 -31 -31 -31 -31 -31 -31 -31 -31 -31 -31 -31
-31 -31 -31 -31 -31 -31 -31 -31 -31 -31 -31 -31 -31 -31 -31 -31 -31 -31 -31 -31 -31 -31 -31 -31 -31
-31 -31 -31 -31 -31 -31 -31 -31 -31 -31 -31 -31 -31 -31 -31 -31 -31 -31 -31 -31 -31 -31 -31 -31 -31
-31 -31 -31 -31 -31 -31 -31 -31 -31 -31 -31 -31 -31 -31 -31 -31 -31 -31 -31 -31 -31 -31 -31 -31 -31
-31 -31 -31 -31 -31 -31 -31 -31 -31 -31 -31 -31 -31 -31 -31 -31 -31 -31 -31 -31 -31 -31 -31 -31 -31
-31 -31 -31 -31 -31 -31 -31 -31 -31 -31 -31 -31 -31 -31 -31 -31 -31 -31 46 56 -31 -31 -31 -31 -31
-31 -31 -31 -31 -31 -31 -31 -31 -31 -31 -31 -31 -31 -31 -31 19 0 0 18 46 -31 -31 -31 -31 -31
-31 -31 -31 -31 -31 -31 -31 -31 -31 -31 -31 -31 -31 -31 13 0 0 0 0 49 46 -31 -31 -31 -31
-31 -31 -31 -31 -31 -31 -31 -31 -31 -31 -31 -31 -31 0 0 0 0 0 0 37 48 51 -31 -31 -31
-31 -31 -31 -31 -31 -31 -31 -31 -31 -31 -31 -31 100 100 100 100 100 0 0 0 0 0 -31 -31 -31
-31 -31 -31 -31 -31 -31 -31 -31 -31 -31 -31 -31 21 0 0 100 100 100 0 0 0 1 -31 -31 -31
-31 -31 -31 -31 -31 -31 -31 -31 -31 -31 -31 -31 -31 21 0 0 0 0 0 0 0 14 -31 -31 -31
-31 -31 -31 -31 -31 -31 -31 -31 -31 -31 -31 -31 -31 -31 40 2 0 0 0 0 0 1 -31 -31 -31
-31 -31 -31 -31 -31 -31 -31 -31 -31 -31 -31 -31 -31 -31 -31 40 0 0 0 0 6 -31 -31 -31 -31
-31 -31 -31 -31 -31 -31 -31 -31 -31 -31 -31 -31 -31 -31 -31 -31 0 0 0 4 -31 -31 -31 -31 -31
-31 -31 -31 -31 -31 -31 -31 -31 -31 -31 -31 -31 -31 -31 -31 -31 -31 -31 -31 -31 -31 -31 -31 -31 -31
-31 -31 -31 -31 -31 -31 -31 -31 -31 -31 -31 -31 -31 -31 -31 -31 -31 -31 -31 -31 -31 -31 -31 -31 -31
-31 -31 -31 -31 -31 -31 -31 -31 -31 -31 -31 -31 -31 -31 -31 -31 -31 -31 -31 -31 -31 -31 -31 -31 -31
-31 -31 -31 -31 -31 -31 -31 -31 -31 -31 -31 -31 -31 -31 -31 -31 -31 -31 -31 -31 -31 -31 -31 -31 -31
-31 -31 -31 -31 -31 -31 -31 -31 -31 -31 -31 -31 -31 -31 -31 -31 -31 -31 -31 -31 -31 -31 -31 -31 -31
-31 -31 -31 -31 -31 -31 -31 -31 -31 -31 -31 -31 -31 -31 -31 -31 -31 -31 -31 -31 -31 -31 -31 -31 -31
-31 -31 -31 -31 -31 -31 -31 -31 -31 -31 -31 -31 -31 -31 -31 -31 -31 -31 -31 -31 -31 -31 -31 -31 -31

