HumanMap-16-38-03
. . . . . . . . . . . . . . . . . . . . . . . . .
. . . . . . . . . . . . . . . . . . . . . . . . .
. . . . . . . . . . . . . . . . . . . . . . . . .
. . . . . . . . . . . . . . . . . . . . . . . . .
. . . . . . . . . . . . . . . . . . . . . . . . .
. . . . . . . . . . . . . . . . . . . . . . . . .
. . . . . . . . . . . . . . . . . . . . . . . . .
. . . . . . . . . . . . . . . . . . . . . . . . .
. . . . . . . . . . ."."."O".".".".". . . . . . .
. . . . . . . . . .".".".".".".".".".". . . . . .
. . . . . . . . .".".".".".".".".".".".". . . . .
. . . . . . . . ."."."."*"*"*"*".".".".". . . . .
. . . . . . . . ."."."."*"."."*".".".".". . . . .
. . . . . . . . .".".".".".".".".".".".". . . . .
. . . . . . . . . ."."."."."."."."."."O". . . . .
. . . . . . . . . . .".".".".".".".". . . . . . .
. . . . . . . . . . . . . . . . . . . . . . . . .
. . . . . . . . . . . . . . . . . . . . . . . . .
. . . . . . . . . . . . . . . . . . . . . . . . .
. . . . . . . . . . . . . . . . . . . . . . . . .
. . . . . . . . . . . . . . . . . . . . . . . . .
. . . . . . . . . . . . . . . . . . . . . . . . .
. . . . . . . . . . . . . . . . . . . . . . . . .
. . . . . . . . . . . . . . . . . . . . . . . . .
. . . . . . . . . . . . . . . . . . . . . . . . .

RawMap-16-38-25
-31 -31 -31 -31 -31 -31 -31 -31 -31 -31 -31 -31 -31 -31 -31 -31 -31 -31 -31 -31 -31 -31 -31 -31 -31
-31 -31 -31 -31 -31 -31 -31 -31 -31 -31 -31 -31 -31 -31 -31 -31 -31 -31 -31 -31 -31 -31 -31 -31 -31
-31 -31 -31 -31 -31 -31 -31 -31 -31 -31 -31 -31 -31 -31 -31 -31 -31 -31 -31 -31 -31 -31 -31 -31 -31
-31 -31 -31 -31 -31 -31 -31 -31 -31 -31 -31 -31 -31 -31 -31 -31 -31 -31 -31 -31 -31 -31 -31 -31 -31
-31 -31 -31 -31 -31 -31 -31 -31 -31 -31 -31 -31 -31 -31 -31 -31 -31 -31 -31 -31 -31 -31 -31 -31 -31
-31 -31 -31 -31 -31 -31 -31 -31 -31 -31 -31 -31 -31 -31 -31 -31 -31 -31 -31 -31 -31 -31 -31 -31 -31
-31 -31 -31 -31 -31 -31 -31 -31 -31 -31 -31 -31 -31 -31 -31 -31 -31 -31 -31 -31 -31 -31 -31 -31 -31
-31 -31 -31 -31 -31 -31 -31 -31 -31 -31 -31 -31 -31 -31 2 0 -31 -31 -31 -31 -31 -31 -31 -31 -31
-31 -31 -31 -31 -31 -31 -31 -31 -31 -31 23 0 0 0 0 2 -31 6 -31 -31 -31 -31 -31 -31 -31
-31 -31 -31 -31 -31 -31 -31 -31 -31 6 0 0 0 0 0 0 0 0 -31 -31 -31 -31 -31 -31 -31
-31 -31 -31 -31 -31 -31 -31 -31 -31 0 0 0 0 0 0 0 0 -31 -31 -31 -31 -31 -31 -31 -31
-31 -31 -31 -31 -31 -31 -31 -31 12 0 0 0 0 100 100 0 0 0 0 -31 -31 -31 -31 -31 -31
-31 -31 -31 -31 -31 -31 -31 -31 3 0 0 0 100 100 100 0 0 0 0 2 -31 -31 -31 -31 -31
-31 -31 -31 -31 -31 -31 -31 -31 12 0 0 0 0 0 100 100 0 0 23 -31 -31 -31 -31 -31 -31
-31 -31 -31 -31 -31 -31 -31 -31 -31 0 0 0 0 0 0 0 0 54 28 -31 -31 -31 -31 -31 -31
-31 -31 -31 -31 -31 -31 -31 -31 -31 23 0 0 0 0 0 0 0 -31 45 -31 -31 -31 -31 -31 -31
-31 -31 -31 -31 -31 -31 -31 -31 -31 -31 -31 6 3 2 0 0 0 -31 -31 -31 -31 -31 -31 -31 -31
-31 -31 -31 -31 -31 -31 -31 -31 -31 -31 -31 -31 -31 -31 -31 -31 0 -31 -31 -31 -31 -31 -31 -31 -31
-31 -31 -31 -31 -31 -31 -31 -31 -31 -31 -31 -31 -31 -31 -31 -31 -31 -31 -31 -31 -31 -31 -31 -31 -31
-31 -31 -31 -31 -31 -31 -31 -31 -31 -31 -31 -31 -31 -31 -31 -31 -31 -31 -31 -31 -31 -31 -31 -31 -31
-31 -31 -31 -31 -31 -31 -31 -31 -31 -31 -31 -31 -31 -31 -31 -31 -31 -31 -31 -31 -31 -31 -31 -31 -31
-31 -31 -31 -31 -31 -31 -31 -31 -31 -31 -31 -31 -31 -31 -31 -31 -31 -31 -31 -31 -31 -31 -31 -31 -31
-31 -31 -31 -31 -31 -31 -31 -31 -31 -31 -31 -31 -31 -31 -31 -31 -31 -31 -31 -31 -31 -31 -31 -31 -31
-31 -31 -31 -31 -31 -31 -31 -31 -31 -31 -31 -31 -31 -31 -31 -31 -31 -31 -31 -31 -31 -31 -31 -31 -31
-31 -31 -31 -31 -31 -31 -31 -31 -31 -31 -31 -31 -31 -31 -31 -31 -31 -31 -31 -31 -31 -31 -31 -31 -31

RawMap-16-38-35
-31 -31 -31 -31 -31 -31 -31 -31 -31 -31 -31 -31 -31 -31 -31 -31 -31 -31 -31 -31 -31 -31 -31 -31 -31
-31 -31 -31 -31 -31 -31 -31 -31 -31 -31 -31 -31 -31 -31 -31 -31 -31 -31 -31 -31 -31 -31 -31 -31 -31
-31 -31 -31 -31 -31 -31 -31 -31 -31 -31 -31 -31 -31 -31 -31 -31 -31 -31 -31 -31 -31 -31 -31 -31 -31
-31 -31 -31 -31 -31 -31 -31 -31 -31 -31 -31 -31 -31 -31 -31 -31 -31 -31 -31 -31 -31 -31 -31 -31 -31
-31 -31 -31 -31 -31 -31 -31 -31 -31 -31 -31 -31 -31 -31 -31 -31 -31 -31 -31 -31 -31 -31 -31 -31 -31
-31 -31 -31 -31 -31 -31 -31 -31 -31 -31 -31 -31 -31 -31 -31 -31 -31 -31 -31 -31 -31 -31 -31 -31 -31
-31 -31 -31 -31 -31 -31 -31 -31 -31 -31 -31 -31 -31 -31 2 0 0 1 -31 -31 -31 -31 -31 -31 -31
-31 -31 -31 -31 -31 -31 -31 -31 -31 -31 -31 -31 -31 4 0 0 0 0 0 -31 -31 -31 -31 -31 -31
-31 -31 -31 -31 -31 -31 -31 -31 -31 -31 23 0 33 0 0 0 0 0 0 9 -31 -31 -31 -31 -31
-31 -31 -31 -31 -31 -31 -31 -31 -31 6 0 0 11 0 0 0 0 0 0 3 -31 -31 -31 -31 -31
-31 -31 -31 -31 -31 -31 -31 -31 -31 0 0 0 0 0 0 100 100 0 0 4 -31 -31 -31 -31 -31
-31 -31 -31 -31 -31 -31 -31 -31 12 0 0 0 0 100 100 0 100 0 0 3 -31 -31 -31 -31 -31
-31 -31 -31 -31 -31 -31 -31 -31 3 0 0 0 100 100 100 0 100 100 0 2 -31 -31 -31 -31 -31
-31 -31 -31 -31 -31 -31 -31 -31 12 0 0 0 0 0 100 100 0 0 0 -31 -31 -31 -31 -31 -31
-31 -31 -31 -31 -31 -31 -31 -31 -31 0 0 0 0 0 0 0 0 0 0 0 -31 -31 -31 -31 -31
-31 -31 -31 -31 -31 -31 -31 -31 -31 23 0 0 0 0 0 0 0 0 2 0 -31 -31 -31 -31 -31
-31 -31 -31 -31 -31 -31 -31 -31 -31 -31 -31 6 3 2 0 0 0 0 17 -31 -31 -31 -31 -31 -31
-31 -31 -31 -31 -31 -31 -31 -31 -31 -31 -31 -31 -31 -31 -31 -31 0 -31 -31 -31 -31 -31 -31 -31 -31
-31 -31 -31 -31 -31 -31 -31 -31 -31 -31 -31 -31 -31 -31 -31 -31 -31 -31 -31 -31 -31 -31 -31 -31 -31
-31 -31 -31 -31 -31 -31 -31 -31 -31 -31 -31 -31 -31 -31 -31 -31 -31 -31 -31 -31 -31 -31 -31 -31 -31
-31 -31 -31 -31 -31 -31 -31 -31 -31 -31 -31 -31 -31 -31 -31 -31 -31 -31 -31 -31 -31 -31 -31 -31 -31
-31 -31 -31 -31 -31 -31 -31 -31 -31 -31 -31 -31 -31 -31 -31 -31 -31 -31 -31 -31 -31 -31 -31 -31 -31
-31 -31 -31 -31 -31 -31 -31 -31 -31 -31 -31 -31 -31 -31 -31 -31 -31 -31 -31 -31 -31 -31 -31 -31 -31
-31 -31 -31 -31 -31 -31 -31 -31 -31 -31 -31 -31 -31 -31 -31 -31 -31 -31 -31 -31 -31 -31 -31 -31 -31
-31 -31 -31 -31 -31 -31 -31 -31 -31 -31 -31 -31 -31 -31 -31 -31 -31 -31 -31 -31 -31 -31 -31 -31 -31

