HumanMap-16-37-51
. . . . . . . . . . . . . . . . . . . . . . . . .
. . . . . . . . . . . . . . . . . . . . . . . . .
. . . . . . . . . . . . . . . . . . . . . . . . .
. . . . . . . . . . . . . . . . . . . . . . . . .
. . . . . . . . . . . . . . . . . . . . . . . . .
. . . . . . . . . . . . . . . . . . . . . . . . .
. . . . . . . . . . . . . . . . . . . . . . . . .
. . . . . . . . . . . O . . . . . . . . . . . . .
. . . . . . . . . . . . . . O . . . . . . . . . .
. . . . . . . . . . . . . . L L L . . . . . . . .
. . . . . . . . . . . . . . L . L L . . O . . . .
. . . . . . . . . . . . . . O L L L L L O . . . .
. . . . . . . . . . . . * * * L L L . . . . . . .
. . . . . . . . . O . . . . * * L * . . . . . . .
. . . . . . . . O * * * . * * . . . . O . . . . .
. . . . . . . . . * . * * * * . . . O O . . . . .
. . . . . . . . . * * * * * * * * * O O . . . . .
. . . . . O O O O . . * . * . . . O O . . . . . .
. . . . . . O O . . . * . . . . . . . . . . . . .
. . . . . . . O . . . * . . . . . . . . . . . . .
. . . . . . . . O O . O . . . . O O . . . . . . .
. . . . . . . . . O O O O O O . . . . . . . . . .
. . . . . . . . . . . . . . . . . . . . . . . . .
. . . . . . . . . . . . . . . . . . . . . . . . .
. . . . . . . . . . . . . . . . . . . . . . . . .

HumanMap-16-38-07
. . . . . . . . . . . . . . . . . . . . . . . . .
. . . . . . . . . . . . . . . . . . . . . . . . .
. . . . . . . . . . . . . . . . . . . . . . . . .
. . . . . . . . . . . . . . . . . . . . . . . . .
. . . . . . . . . . . . . . . . . . . . . . . . .
. . . . . . . . . . . . . . . . . . . . . . . . .
. . . . . . . . . . . . . O . . . . . . . . . . .
. . . . . . . . . . . . . O . . . . . . . . . . .
. . . . . . . . . . . . . . . . . . . . . . . . .
. . . . . . . . . . . . . . . . O . . . . . . . .
. . . . . . . . . . . . . . . . O O . . . . . . .
. . . . . . . . . O O . * * . . O . . . . . . . .
. . . . . . . . . O . * * . . O O . . . . . . . .
. . . . . . . . . O . . . . . . O O . . . . . . .
. . . . . . . O . O O . . . . . . O . . . . . . .
. . . . . . . . . . O . . . . . . . . . . . . . .
. . . . . . . . O O O O . . . . . . . . . . . . .
. . . . . . . . . . . O . . . . . . . . . . . . .
. . . . . . . . . . . . . . . . . . . . . . . . .
. . . . . . . . . . . . . . . . . . . . . . . . .
. . . . . . . . . . . . . . . . . . . . . . . . .
. . . . . . . . . . . . . . . . . . . . . . . . .
. . . . . . . . . . . . . . . . . . . . . . . . .
. . . . . . . . . . . . . . . . . . . . . . . . .
. . . . . . . . . . . . . . . . . . . . . . . . .

HumanMap-16-38-16
. . . . . . . . . . . . . . . . . . . . . . . . .
. . . . . . . . . . . . . . . . . . . . . . . . .
. . . . . . . . . . . . . . . . . . . . . . . . .
. . . . . . . . . . . . . . . . . . . . . . . . .
. . . . . . . . . . . . . . . . . . . . . . . . .
. . . . . . . . . . . . . . . . . . . . . . . . .
. . . . . . . . . . . . . O . . . . . . . . . . .
. . . . . . . . . . . . . O . . . . . . . . . . .
. . . . . . . O . . . . . . . O O O . . . . . . .
. . . . . . . . . . O O O O O O . . . . . . . . .
. . . . . . . . . . . . . . O . O O . . . . . . .
. . . . . . O . . O . * . . . . O . . . . . . . .
. . . . . . O . . . . * * . . O O . . . . . . . .
. . . . . . O . . O . . . . . . O O . . . . . . .
. . . . . . . O . O O . . . . . . O . . . . . . .
. . . . . . . . . . O . . . . . . . . . . . . . .
. . . . . . . . O O O O . . . . . . . . . . . . .
. . . . . . . . . . . O . . . . . . . . . . . . .
. . . . . . . . . . . . . . . . . . . . . . . . .
. . . . . . . . . . . . . . . . . . . . . . . . .
. . . . . . . . . . . . . . . . . . . . . . . . .
. . . . . . . . . . . . . . . . . . . . . . . . .
. . . . . . . . . . . . . . . . . . . . . . . . .
. . . . . . . . . . . . . . . . . . . . . . . . .
. . . . . . . . . . . . . . . . . . . . . . . . .

HumanMap-16-38-26
. . . . . . . . . . . . . . . . . . . . . . . . .
. . . . . . . . . . . . . . . . . . . . . . . . .
. . . . . . . . . . . . . . . . . . . . . . . . .
. . . . . . . . . . . . . . . . . . . . . . . . .
. . . . . . . . . . . . . . . . . . . . . . . . .
. . . . . . . . . . . . . . . . . . . . . . . . .
. . . . . . . . . . . . . O . . . . . . . . . . .
. . . . . . . . . . . . . O . . . . . . . . . . .
. . . . . . . O . . . . . . . O O O . . . . . . .
. . . . . . . . . . O O O O O O . . . . . . . . .
. . . . . . . O . . . . . . O . O O . . . . . . .
. . . . . . O O O . . * * . . . O . . . . . . . .
. . . . . . O . . . . * * . . O O . . . . . . . .
. . . . . . O O O . . . . . . . O O . . . . . . .
. . . . . . . O O . O O . . . . . O . . . . . . .
. . . . . . . O O . O . . . . . . . . . . . . . .
. . . . . . . . O O O O . . . . . . . . . . . . .
. . . . . . . . . . . O . . . . . . . . . . . . .
. . . . . . . . . . . . . . . . . . . . . . . . .
. . . . . . . . . . . . . . . . . . . . . . . . .
. . . . . . . . . . . . . . . . . . . . . . . . .
. . . . . . . . . . . . . . . . . . . . . . . . .
. . . . . . . . . . . . . . . . . . . . . . . . .
. . . . . . . . . . . . . . . . . . . . . . . . .
. . . . . . . . . . . . . . . . . . . . . . . . .

HumanMap-16-38-36
. . . . . . . . . . . . . . . . . . . . . . . . .
. . . . . . . . . . . . . . . . . . . . . . . . .
. . . . . . . . . . . . . . . . . . . . . . . . .
. . . . . . . . . . . . . . . . . . . . . . . . .
. . . . . . . . . . . . . . . . . . . . . . . . .
. . . . . . . . . . . . . . . . . . . . . . . . .
. . . . . . . . . . . . . O . . . . . . . . . . .
. . . . . . . . . . . . . O . . . . . . . . . . .
. . . . . . . O . . . . . O . O O O . . . . . . .
. . . . . . . . . . O O . . O O . . . . . . . . .
. . . . . . . O . . . . . . O O O O . . . . . . .
. . . . . . O O O . . . . . . . O . . . . . . . .
. . . . . . O . . . . * * . . . O O . . . . . . .
. . . . . . O O . . . . . . . . O O . . . . . . .
. . . . . . . O O . O O . O O . . O . . . . . . .
. . . . . . . O O . O . . O . . . . . . . . . . .
. . . . . . . . O O O O . O . . . . . . . . . . .
. . . . . . . . . . . O . O . . . . . . . . . . .
. . . . . . . . . . . . . . . . . . . . . . . . .
. . . . . . . . . . . . . . . . . . . . . . . . .
. . . . . . . . . . . . . . . . . . . . . . . . .
. . . . . . . . . . . . . . . . . . . . . . . . .
. . . . . . . . . . . . . . . . . . . . . . . . .
. . . . . . . . . . . . . . . . . . . . . . . . .
. . . . . . . . . . . . . . . . . . . . . . . . .

HumanMap-16-38-46
. . . . . . . . . . . . . . . . . . . . . . . . .
. . . . . . . . . . . . . . . . . . . . . . . . .
. . . . . . . . . . . . . . . . . . . . . . . . .
. . . . . . . . . . . . . . . . . . . . . . . . .
. . . . . . . . . . . . . . . . . . . . . . . . .
. . . . . . . . . . . . . . . . . . . . . . . . .
. . . . . . . . . . . . . O . . . . . . . . . . .
. . . . . . . . . . . . . O . . . . . . . . . . .
. . . . . . . O . . . . . O . O O O . . . . . . .
. . . . . . . . . . O O . . O O . . . . . . . . .
. . . . . . . O . . . . . . . . O O . . . . . . .
. . . . . . O O O . . . . . . O O . . . . . . . .
. . . . . . O . . . . * * . . . O O . . . . . . .
. . . . . . O O . . . . * . . . O O . . . . . . .
. . . . . . . O O . O O * * O O O O . . . . . . .
. . . . . . . O O . O . . O O . . . . . . . . . .
. . . . . . . . O O O O . O . . . . . . . . . . .
. . . . . . . . . . . O . O . . . . . . . . . . .
. . . . . . . . . . . . . . . . . . . . . . . . .
. . . . . . . . . . . . . . . . . . . . . . . . .
. . . . . . . . . . . . . . . . . . . . . . . . .
. . . . . . . . . . . . . . . . . . . . . . . . .
. . . . . . . . . . . . . . . . . . . . . . . . .
. . . . . . . . . . . . . . . . . . . . . . . . .
. . . . . . . . . . . . . . . . . . . . . . . . .

HumanMap-16-38-56
. . . . . . . . . . . . . . . . . . . . . . . . .
. . . . . . . . . . . . . . . . . . . . . . . . .
. . . . . . . . . . . . . . . . . . . . . . . . .
. . . . . . . . . . . . . . . . . . . . . . . . .
. . . . . . . . . . . . . . . . . . . . . . . . .
. . . . . . . . . . . . . . . . . . O O . . . . .
. . . . . . . . . . . . . O . . . . . . . . . . .
. . . . . . . . . . . . . O . . . . . . . . . . .
. . . . . . . O . . . . . O . O O O . . . . . . .
. . . . . . . . . . O O . . O O . . . . . . . . .
. . . . . . . O . . . . . . . . O O * * . . . . .
. . . . . . O O O . . . . . . O O * * . . . . . .
. . . . . . O . . . . * * . . . * * . . . . . . .
. . . . . . O O . . . . * . . * * O . . . . . . .
. . . . . . . O O . O O * * * O O O . . . . . . .
. . . . . . . O O . O . . O O . . . . . . . . . .
. . . . . . . . O O O O . O . . . . . . . . . . .
. . . . . . . . . . . O . O . . . . . . . . . . .
. . . . . . . . . . . L . . . . . . . . . . . . .
. . . . . . . . . . . . . . . . . . . . . . . . .
. . . . . . . . . . . . . . . . . . . . . . . . .
. . . . . . . . . . . . . . . . . . . . . . . . .
. . . . . . . . . . . . . . . . . . . . . . . . .
. . . . . . . . . . . . . . . . . . . . . . . . .
. . . . . . . . . . . . . . . . . . . . . . . . .

HumanMap-16-39-06
. . . . . . . . . . . . . . . . . . . . . . . . .
. . . . . . . . . . . . . . . . . . . . . . . . .
. . . . . . . . . . . . . . . . . . . . . . . . .
. . . . . . . . . . . . . . . . . . . . . . . . .
. . . . . . . . . . . . . . . . . . . . . . . . .
. . . . . . . . . . . . . . . . . . O O . . . . .
. . . . . . . . . . . . . O . * * * . . . . . . .
. . . . . . . . . . . . . O . . . * * . . . . . .
. . . . . . . O . . . . . O . O O O * * . . . . .
. . . . . . . . . . O O . . O O . . . * . . . . .
. . . . . . . O . . . . . . . . O O * * . . . . .
. . . . . . O O O . . . . . . O O * * . . . . . .
. . . . . . O . . . . * * . . . * * . . . . . . .
. . . . . . O O . . . . * . . * * O . . . . . . .
. . . . . . . O O . O O * * * O O O . . . . . . .
. . . . . . . O O . O . . O O . . . . . . . . . .
. . . . . . . . O O O O . O . . . . . . . . . . .
. . . . . . . . . . . O . O . . . . . . . . . . .
. . . . . . . . . . . L . . . . . . . . . . . . .
. . . . . . . . . . L . . . . . . . . . . . . . .
. . . . . . . . . . . . . . . . . . . . . . . . .
. . . . . . . . . . . . . . . . . . . . . . . . .
. . . . . . . . . . . . . . . . . . . . . . . . .
. . . . . . . . . . . . . . . . . . . . . . . . .
. . . . . . . . . . . . . . . . . . . . . . . . .

HumanMap-16-39-16
. . . . . . . . . . . . . . . . . . . . . . . . .
. . . . . . . . . . . . . . . . . . . . . . . . .
. . . . . . . . . . . . . . . . . . . . . . . . .
. . . . . . . . . . . . . . . . . . . . . . . . .
. . . . . . . . . . . . . . . . . . . . . . . . .
. . . . . . . . . . . * * * . . . . O O . . . . .
. . . . . . . . . . * * . * * * * * . . . . . . .
. . . . . . . . . . * . . O . . . * * . . . . . .
. . . . . . . O . . . . . O . O O O * * . . . . .
. . . . . . . . . . O O . . O O . . . * . . . . .
. . . . . . L O . . . . . . . . O O * * . . . . .
. . . . . . L O O . . . . . . O O * * . . . . . .
. . . . . L O . . . . * * . . . * * . . . . . . .
. . . . . L O O . . . . * . . * * O . . . . . . .
. . . . . . L O O . O O * * * O O O . . . . . . .
. . . . . . L O O . O . . O O . . . . . . . . . .
. . . . . . . . O O O O . O . . . . . . . . . . .
. . . . . . . . . . . O . O . . . . . . . . . . .
. . . . . . . . . . . L . . . . . . . . . . . . .
. . . . . . . . . . L . . . . . . . . . . . . . .
. . . . . . . . . . . . . . . . . . . . . . . . .
. . . . . . . . . . . . . . . . . . . . . . . . .
. . . . . . . . . . . . . . . . . . . . . . . . .
. . . . . . . . . . . . . . . . . . . . . . . . .
. . . . . . . . . . . . . . . . . . . . . . . . .

HumanMap-16-39-26
. . . . . . . . . . . . . . . . . . . . . . . . .
. . . . . . . . . . . . . . . . . . . . . . . . .
. . . . . . . . . . . . . . . . . . . . . . . . .
. . . . . . . . . . . . . . . . . . . . . . . . .
. . . . . . . . . . . . . . . . . . . . . . . . .
. . . . . . . . . . . * * * . . . . O O . . . . .
. . . . . . . . . . * * . * * * * * . . . . . . .
. . . . . . . . . . * . . O . . . * * . . . . . .
. . . . . . . O . . * * * O . O O O * * . . . . .
. . . . . . . . . . O . * . O O . . . * . . . . .
. . . . . . L O . . . . * * . . O O * * . . . . .
. . . . . . L O O . . . . . . O O * * . . . . . .
. . . . . L O . . . . * * . O . * * . . . . . . .
. . . . . L O O . . . . * . . * * O . . . . . . .
. . . . . . L O O . O O * * * O O O . . . . . . .
. . . . . . L O O . O . . O O . . . . . . . . . .
. . . . . . . . O O O O . O . . . . . . . . . . .
. . . . . . . . . . . O . O . . . . . . . . . . .
. . . . . . . . . . . L . . . . . . . . . . . . .
. . . . . . . . . . L . . . . . . . . . . . . . .
. . . . . . . . . . . . . . . . . . . . . . . . .
. . . . . . . . . . . . . . . . . . . . . . . . .
. . . . . . . . . . . . . . . . . . . . . . . . .
. . . . . . . . . . . . . . . . . . . . . . . . .
. . . . . . . . . . . . . . . . . . . . . . . . .

HumanMap-16-39-36
. . . . . . . . . . . . . . . . . . . . . . . . .
. . . . . . . . . . . . . . . . . . . . . . . . .
. . . . . . . . . . . . . . . . . . . . . . . . .
. . . . . . . . . . . . . . . . . . . . . . . . .
. . . . . . . . . . . . . . . . . . . . . . . . .
. . . . . . . . . . . * * * . . . . O O . . . . .
. . . . . . . . . . * * . * * * * * . . . . . . .
. . . . . . . . . . * . . O . . . * * . . . . . .
. . . . . . . O . . * * * O . O O O * * . . . . .
. . . . . . . . . . O . * . O O . . . * . . . . .
. . . . . . L O . . . . * * * * O O * * . . . . .
. . . . . . L O O . . . . . . * * * * . . . . . .
. . . . . L O . . . . * * . O . * * * * . . . . .
. . . . . L O O . . . . * . . * * O . . . . . . .
. . . . . . L O O . O O * * * O O O . . . . . . .
. . . . . . L O O . O . . O O . . . . . . . . . .
. . . . . . . . O O O L . O . . . . . . . . . . .
. . . . . . . . . . . L . O . . . . . . . . . . .
. . . . . . . . . . . L L . . . . . . . . . . . .
. . . . . . . . . . L . . . . . . . . . . . . . .
. . . . . . . . . . . . . . . . . . . . . . . . .
. . . . . . . . . . . . . . . . . . . . . . . . .
. . . . . . . . . . . . . . . . . . . . . . . . .
. . . . . . . . . . . . . . . . . . . . . . . . .
. . . . . . . . . . . . . . . . . . . . . . . . .

HumanMap-16-39-46
. . . . . . . . . . . . . . . . . . . . . . . . .
. . . . . . . . . . . . . . . . . . . . . . . . .
. . . . . . . . . . . . . . . . . . . . . . . . .
. . . . . . . . . . . . . . . . . . . . . . . . .
. . . . . . . . . . . . . . . . . . . . . . . . .
. . . . . . . . . . . * * * . . . . O O . . . . .
. . . . . . . . . . * * . * * * * * . . . . . . .
. . . . . . . . . . * . . O . . . * * . . . . . .
. . . . . . . O . . * * * O . O O O * * . . . . .
. . . . . . . . . . O . * . O O . . . * . . . . .
. . . . . . L O . . . . * * * * O O * * . . . . .
. . . . . . L O O . . . . . . * * * * . . . . . .
. . . . . L O . . . . * * . O . * * * * * * * . .
. . . . . L O O . . . . * . . * * O . . . . . . .
. . . . . . L O O . O O * * * O O O . . . . . . .
. . . . . . L O O . O . . O O . . . . . . . . . .
. . . . . . . . O O O L . O . . . . . . . . . . .
. . . . . . . . . . . L . O . . . . . . . . . . .
. . . . . . . . . . . L L . . . . . . . . . . . .
. . . . . . . . . . L . . . . . . . . . . . . . .
. . . . . . . . . . . . L . . . . . . . . . . . .
. . . . . . . . . . . . L . . . . . . . . . . . .
. . . . . . . . . . . . L . . . . . . . . . . . .
. . . . . . . . . . . . . . . . . . . . . . . . .
. . . . . . . . . . . . . . . . . . . . . . . . .

