HumanMap-16-07-28
. . . . . . . . . . . . . . . . . . . . . . . . .
. . . . . . . . . . . . . . . . . . . . . . . . .
. . * . . . . . . . . . . . . . * * * * * . . . .
. . * * . . . . . . . . . . . . * . * * . . . . .
. . . * . . . . . . . . . . . * * . * . . . . . .
. . . * * * * * * . . . . . . * . . . . . . . . .
. . . . * * . . * * * * . . * * . . . . . . . . .
. . O . O * . . . . O * * * * . . . . . . . . . .
. O O . * * . . O O O O O O . O . . . . . . . . .
. . . . * * . . O O O O . O O . O . . . . . . . .
. O . . * * O O O O O . . O O . O . . . . . . . .
. O . . * O O . O O . . * . . O O O . . . . . . .
O O . * * . . . . O * * * . . O . . . . . . . . .
O . * * * * . . . * * * * . . . . . . . . . . . .
O . * * * * * * * * * * . . . . . . . . . . . . .
. . . * * * . O O . O . . . . . . . . . . . . . .
. . . O . . . O . . . . . . . . . . . . . . . . .
. . . . . . . O O . . . . . . . . . . . . . . . .
. . . . . . . . . . . . . . . . . . . . . . . . .
. . . . . . . . . . . . . . . . . . . . . . . . .
. . . . . . . . . . . . . . . . . . . . . . . . .
. . . . . . . . . . . . . . . . . . . . . . . . .
. . . . . . . . . . . . . . . . . . . . . . . . .
. . . . . . . . . . . . . . . . . . . . . . . . .
. . . . . . . . . . . . . . . . . . . . . . . . .

RawMap-16-08-07
-31 -31 -31 -31 -31 -31 -31 -31 -31 -31 -31 -31 -31 -31 -31 -31 -31 -31 -31 -31 -31 -31 -31 -31 -31
-31 -31 -31 -31 -31 -31 -31 -31 -31 -31 -31 -31 -31 -31 -31 -31 -31 -31 -31 -31 -31 -31 -31 -31 -31
-31 -31 -31 -31 -31 -31 -31 -31 -31 -31 -31 -31 -31 -31 -31 -31 -31 -31 -31 -31 -31 -31 -31 -31 -31
-31 -31 -31 -31 -31 -31 -31 -31 -31 -31 -31 -31 -31 -31 -31 -31 -31 -31 -31 -31 -31 -31 -31 -31 -31
-31 -31 -31 -31 -31 -31 -31 -31 -31 -31 -31 -31 -31 -31 -31 -31 -31 -31 -31 -31 -31 -31 -31 -31 -31
-31 -31 -31 -31 -31 -31 -31 -31 -31 -31 -31 -31 -31 -31 -31 -31 -31 -31 -31 -31 -31 -31 -31 -31 -31
-31 -31 -31 -31 -31 -31 -31 -31 -31 -31 -31 -31 -31 -31 -31 -31 -31 -31 -31 -31 -31 -31 -31 -31 -31
-31 -31 -31 -31 -31 -31 -31 -31 -31 -31 -31 -31 60 40 -31 -31 -31 -31 -31 -31 -31 -31 -31 -31 -31
-31 -31 -31 -31 -31 -31 -31 -31 -31 -31 -31 -31 0 60 -31 -31 -31 -31 -31 -31 -31 -31 -31 -31 -31
-31 -31 -31 -31 -31 -31 -31 -31 -31 -31 -31 -31 0 49 -31 -31 -31 -31 -31 -31 -31 -31 -31 -31 -31
-31 -31 -31 -31 -31 -31 -31 -31 -31 -31 -31 -31 0 0 -31 21 40 -31 -31 -31 -31 -31 -31 -31 -31
-31 -31 -31 -31 -31 -31 -31 -31 -31 -31 -31 -31 100 100 0 46 -31 -31 -31 -31 -31 -31 -31 -31 -31
-31 -31 -31 -31 -31 -31 -31 -31 -31 -31 -31 101 100 0 0 37 44 40 -31 -31 -31 -31 -31 -31 -31
-31 -31 -31 -31 -31 -31 -31 -31 -31 -31 -31 -31 0 0 0 20 40 58 -31 -31 -31 -31 -31 -31 -31
-31 -31 -31 -31 -31 -31 -31 -31 -31 -31 -31 -31 0 0 -31 40 40 51 -31 -31 -31 -31 -31 -31 -31
-31 -31 -31 -31 -31 -31 -31 -31 -31 -31 -31 -31 25 0 19 -31 -31 -31 -31 -31 -31 -31 -31 -31 -31
-31 -31 -31 -31 -31 -31 -31 -31 -31 -31 -31 -31 -31 58 37 -31 -31 -31 -31 -31 -31 -31 -31 -31 -31
-31 -31 -31 -31 -31 -31 -31 -31 -31 -31 -31 -31 -31 -31 40 -31 -31 -31 -31 -31 -31 -31 -31 -31 -31
-31 -31 -31 -31 -31 -31 -31 -31 -31 -31 -31 -31 -31 -31 -31 -31 -31 -31 -31 -31 -31 -31 -31 -31 -31
-31 -31 -31 -31 -31 -31 -31 -31 -31 -31 -31 -31 -31 -31 -31 -31 -31 -31 -31 -31 -31 -31 -31 -31 -31
-31 -31 -31 -31 -31 -31 -31 -31 -31 -31 -31 -31 -31 -31 -31 -31 -31 -31 -31 -31 -31 -31 -31 -31 -31
-31 -31 -31 -31 -31 -31 -31 -31 -31 -31 -31 -31 -31 -31 -31 -31 -31 -31 -31 -31 -31 -31 -31 -31 -31
-31 -31 -31 -31 -31 -31 -31 -31 -31 -31 -31 -31 -31 -31 -31 -31 -31 -31 -31 -31 -31 -31 -31 -31 -31
-31 -31 -31 -31 -31 -31 -31 -31 -31 -31 -31 -31 -31 -31 -31 -31 -31 -31 -31 -31 -31 -31 -31 -31 -31
-31 -31 -31 -31 -31 -31 -31 -31 -31 -31 -31 -31 -31 -31 -31 -31 -31 -31 -31 -31 -31 -31 -31 -31 -31

RawMap-16-08-17
-31 -31 -31 -31 -31 -31 -31 -31 -31 -31 -31 -31 -31 -31 -31 -31 -31 -31 -31 -31 -31 -31 -31 -31 -31
-31 -31 -31 -31 -31 -31 -31 -31 -31 -31 -31 -31 -31 -31 -31 -31 -31 -31 -31 -31 -31 -31 -31 -31 -31
-31 -31 -31 -31 -31 -31 -31 -31 -31 -31 -31 -31 -31 -31 -31 -31 -31 -31 -31 -31 -31 -31 -31 -31 -31
-31 -31 -31 -31 -31 -31 -31 -31 -31 -31 -31 -31 -31 -31 -31 -31 -31 -31 -31 -31 -31 -31 -31 -31 -31
-31 -31 -31 -31 -31 -31 -31 -31 -31 -31 -31 -31 -31 -31 -31 -31 -31 -31 -31 -31 -31 -31 -31 -31 -31
-31 -31 -31 -31 -31 -31 -31 -31 -31 -31 -31 -31 -31 -31 -31 -31 -31 -31 -31 -31 -31 -31 -31 -31 -31
-31 -31 -31 -31 -31 -31 -31 -31 -31 -31 -31 -31 -31 -31 -31 -31 -31 -31 -31 -31 -31 -31 -31 -31 -31
-31 -31 -31 -31 -31 -31 -31 -31 -31 -31 -31 -31 60 56 51 -31 -31 -31 -31 -31 -31 -31 -31 -31 -31
-31 -31 -31 -31 -31 -31 -31 -31 -31 -31 -31 -31 14 4 60 -31 -31 -31 -31 -31 -31 -31 -31 -31 -31
-31 -31 -31 -31 -31 -31 -31 -31 -31 -31 -31 -31 0 0 14 -31 -31 -31 -31 -31 -31 -31 -31 -31 -31
-31 -31 -31 -31 -31 -31 -31 -31 -31 -31 -31 -31 0 0 25 21 40 -31 -31 -31 -31 -31 -31 -31 -31
-31 -31 -31 -31 -31 -31 -31 -31 -31 -31 -31 0 100 100 0 46 -31 -31 -31 -31 -31 -31 -31 -31 -31
-31 -31 -31 -31 -31 -31 -31 -31 -31 -31 -31 100 100 0 0 7 30 46 -31 -31 -31 -31 -31 -31 -31
-31 -31 -31 -31 -31 -31 -31 -31 -31 -31 -31 -31 0 0 0 0 49 58 -31 -31 -31 -31 -31 -31 -31
-31 -31 -31 -31 -31 -31 -31 -31 -31 -31 -31 -31 0 0 -31 40 51 58 -31 -31 -31 -31 -31 -31 -31
-31 -31 -31 -31 -31 -31 -31 -31 -31 -31 -31 -31 25 0 19 -31 -31 -31 -31 -31 -31 -31 -31 -31 -31
-31 -31 -31 -31 -31 -31 -31 -31 -31 -31 -31 -31 -31 58 37 -31 -31 -31 -31 -31 -31 -31 -31 -31 -31
-31 -31 -31 -31 -31 -31 -31 -31 -31 -31 -31 -31 -31 -31 40 -31 -31 -31 -31 -31 -31 -31 -31 -31 -31
-31 -31 -31 -31 -31 -31 -31 -31 -31 -31 -31 -31 -31 -31 -31 -31 -31 -31 -31 -31 -31 -31 -31 -31 -31
-31 -31 -31 -31 -31 -31 -31 -31 -31 -31 -31 -31 -31 -31 -31 -31 -31 -31 -31 -31 -31 -31 -31 -31 -31
-31 -31 -31 -31 -31 -31 -31 -31 -31 -31 -31 -31 -31 -31 -31 -31 -31 -31 -31 -31 -31 -31 -31 -31 -31
-31 -31 -31 -31 -31 -31 -31 -31 -31 -31 -31 -31 -31 -31 -31 -31 -31 -31 -31 -31 -31 -31 -31 -31 -31
-31 -31 -31 -31 -31 -31 -31 -31 -31 -31 -31 -31 -31 -31 -31 -31 -31 -31 -31 -31 -31 -31 -31 -31 -31
-31 -31 -31 -31 -31 -31 -31 -31 -31 -31 -31 -31 -31 -31 -31 -31 -31 -31 -31 -31 -31 -31 -31 -31 -31
-31 -31 -31 -31 -31 -31 -31 -31 -31 -31 -31 -31 -31 -31 -31 -31 -31 -31 -31 -31 -31 -31 -31 -31 -31

RawMap-16-08-27
-31 -31 -31 -31 -31 -31 -31 -31 -31 -31 -31 -31 -31 -31 -31 -31 -31 -31 -31 -31 -31 -31 -31 -31 -31
-31 -31 -31 -31 -31 -31 -31 -31 -31 -31 -31 -31 -31 -31 -31 -31 -31 -31 -31 -31 -31 -31 -31 -31 -31
-31 -31 -31 -31 -31 -31 -31 -31 -31 -31 -31 -31 -31 -31 -31 -31 -31 -31 -31 -31 -31 -31 -31 -31 -31
-31 -31 -31 -31 -31 -31 -31 -31 -31 -31 -31 -31 -31 -31 -31 -31 -31 -31 -31 -31 -31 -31 -31 -31 -31
-31 -31 -31 -31 -31 -31 -31 -31 -31 -31 -31 -31 -31 -31 -31 -31 -31 -31 -31 -31 -31 -31 -31 -31 -31
-31 -31 -31 -31 -31 -31 -31 -31 -31 -31 -31 -31 -31 -31 -31 -31 -31 -31 -31 -31 -31 -31 -31 -31 -31
-31 -31 -31 -31 -31 -31 -31 -31 -31 -31 -31 -31 -31 -31 -31 -31 -31 -31 -31 -31 -31 -31 -31 -31 -31
-31 -31 -31 -31 -31 -31 -31 -31 -31 -31 -31 -31 60 56 51 -31 -31 -31 -31 -31 -31 -31 -31 -31 -31
-31 -31 -31 -31 -31 -31 -31 -31 -31 -31 -31 -31 14 22 60 40 -31 -31 -31 -31 -31 -31 -31 -31 -31
-31 -31 -31 -31 -31 -31 -31 -31 -31 -31 -31 -31 0 0 56 56 38 -31 -31 -31 -31 -31 -31 -31 -31
-31 -31 -31 -31 -31 -31 -31 -31 -31 -31 -31 -31 0 0 7 13 40 -31 -31 -31 -31 -31 -31 -31 -31
-31 -31 -31 -31 -31 -31 -31 -31 -31 -31 -31 0 100 100 0 46 -31 -31 -31 -31 -31 -31 -31 -31 -31
-31 -31 -31 -31 -31 -31 -31 -31 -31 -31 -31 100 100 100 0 0 4 46 -31 -31 -31 -31 -31 -31 -31
-31 -31 -31 -31 -31 -31 -31 -31 -31 -31 -31 -31 0 0 0 60 56 60 -31 -31 -31 -31 -31 -31 -31
-31 -31 -31 -31 -31 -31 -31 -31 -31 -31 -31 -31 0 0 23 54 51 58 -31 -31 -31 -31 -31 -31 -31
-31 -31 -31 -31 -31 -31 -31 -31 -31 -31 -31 -31 25 0 28 -31 51 -31 -31 -31 -31 -31 -31 -31 -31
-31 -31 -31 -31 -31 -31 -31 -31 -31 -31 -31 -31 -31 58 37 40 -31 -31 -31 -31 -31 -31 -31 -31 -31
-31 -31 -31 -31 -31 -31 -31 -31 -31 -31 -31 -31 -31 -31 40 -31 -31 -31 -31 -31 -31 -31 -31 -31 -31
-31 -31 -31 -31 -31 -31 -31 -31 -31 -31 -31 -31 -31 -31 -31 -31 -31 -31 -31 -31 -31 -31 -31 -31 -31
-31 -31 -31 -31 -31 -31 -31 -31 -31 -31 -31 -31 -31 -31 -31 -31 -31 -31 -31 -31 -31 -31 -31 -31 -31
-31 -31 -31 -31 -31 -31 -31 -31 -31 -31 -31 -31 -31 -31 -31 -31 -31 -31 -31 -31 -31 -31 -31 -31 -31
-31 -31 -31 -31 -31 -31 -31 -31 -31 -31 -31 -31 -31 -31 -31 -31 -31 -31 -31 -31 -31 -31 -31 -31 -31
-31 -31 -31 -31 -31 -31 -31 -31 -31 -31 -31 -31 -31 -31 -31 -31 -31 -31 -31 -31 -31 -31 -31 -31 -31
-31 -31 -31 -31 -31 -31 -31 -31 -31 -31 -31 -31 -31 -31 -31 -31 -31 -31 -31 -31 -31 -31 -31 -31 -31
-31 -31 -31 -31 -31 -31 -31 -31 -31 -31 -31 -31 -31 -31 -31 -31 -31 -31 -31 -31 -31 -31 -31 -31 -31

RawMap-16-08-37
-31 -31 -31 -31 -31 -31 -31 -31 -31 -31 -31 -31 -31 -31 -31 -31 -31 -31 -31 -31 -31 -31 -31 -31 -31
-31 -31 -31 -31 -31 -31 -31 -31 -31 -31 -31 -31 -31 -31 -31 -31 -31 -31 -31 -31 -31 -31 -31 -31 -31
-31 -31 -31 -31 -31 -31 -31 -31 -31 -31 -31 -31 -31 -31 -31 -31 -31 -31 -31 -31 -31 -31 -31 -31 -31
-31 -31 -31 -31 -31 -31 -31 -31 -31 -31 -31 -31 -31 -31 -31 -31 -31 -31 -31 -31 -31 -31 -31 -31 -31
-31 -31 -31 -31 -31 -31 -31 -31 -31 -31 -31 -31 -31 -31 -31 -31 -31 -31 -31 -31 -31 -31 -31 -31 -31
-31 -31 -31 -31 -31 -31 -31 -31 -31 -31 -31 -31 -31 -31 -31 -31 -31 -31 -31 -31 -31 -31 -31 -31 -31
-31 -31 -31 -31 -31 -31 -31 -31 -31 -31 -31 -31 -31 -31 -31 -31 -31 -31 -31 -31 -31 -31 -31 -31 -31
-31 -31 -31 -31 -31 -31 -31 -31 -31 -31 -31 -31 60 56 51 -31 -31 -31 -31 -31 -31 -31 -31 -31 -31
-31 -31 -31 -31 -31 -31 -31 -31 -31 -31 -31 -31 14 22 60 40 -31 -31 -31 -31 -31 -31 -31 -31 -31
-31 -31 -31 -31 -31 -31 -31 -31 -31 -31 -31 -31 0 0 56 56 38 -31 -31 -31 -31 -31 -31 -31 -31
-31 -31 -31 -31 -31 -31 -31 -31 -31 -31 -31 -31 0 0 7 13 40 -31 -31 -31 -31 -31 -31 -31 -31
-31 -31 -31 -31 -31 -31 -31 -31 21 14 6 100 100 100 0 46 -31 -31 -31 -31 -31 -31 -31 -31 -31
-31 -31 -31 -31 -31 -31 -31 40 46 14 1 100 100 100 0 0 4 46 -31 -31 -31 -31 -31 -31 -31
-31 -31 -31 -31 -31 -31 -31 -31 -31 53 0 100 0 0 0 60 56 60 -31 -31 -31 -31 -31 -31 -31
-31 -31 -31 -31 -31 -31 -31 -31 -31 46 0 0 0 3 59 54 51 58 -31 -31 -31 -31 -31 -31 -31
-31 -31 -31 -31 -31 -31 -31 -31 46 -31 0 0 25 0 45 -31 51 -31 -31 -31 -31 -31 -31 -31 -31
-31 -31 -31 -31 -31 -31 -31 -31 -31 -31 60 0 -31 58 44 40 -31 -31 -31 -31 -31 -31 -31 -31 -31
-31 -31 -31 -31 -31 -31 -31 -31 -31 -31 38 50 -31 -31 40 -31 -31 -31 -31 -31 -31 -31 -31 -31 -31
-31 -31 -31 -31 -31 -31 -31 -31 -31 -31 51 -31 -31 -31 -31 -31 -31 -31 -31 -31 -31 -31 -31 -31 -31
-31 -31 -31 -31 -31 -31 -31 -31 -31 -31 -31 -31 -31 -31 -31 -31 -31 -31 -31 -31 -31 -31 -31 -31 -31
-31 -31 -31 -31 -31 -31 -31 -31 -31 -31 -31 -31 -31 -31 -31 -31 -31 -31 -31 -31 -31 -31 -31 -31 -31
-31 -31 -31 -31 -31 -31 -31 -31 -31 -31 -31 -31 -31 -31 -31 -31 -31 -31 -31 -31 -31 -31 -31 -31 -31
-31 -31 -31 -31 -31 -31 -31 -31 -31 -31 -31 -31 -31 -31 -31 -31 -31 -31 -31 -31 -31 -31 -31 -31 -31
-31 -31 -31 -31 -31 -31 -31 -31 -31 -31 -31 -31 -31 -31 -31 -31 -31 -31 -31 -31 -31 -31 -31 -31 -31
-31 -31 -31 -31 -31 -31 -31 -31 -31 -31 -31 -31 -31 -31 -31 -31 -31 -31 -31 -31 -31 -31 -31 -31 -31

RawMap-16-08-47
-31 -31 -31 -31 -31 -31 -31 -31 -31 -31 -31 -31 -31 -31 -31 -31 -31 -31 -31 -31 -31 -31 -31 -31 -31
-31 -31 -31 -31 -31 -31 -31 -31 -31 -31 -31 -31 -31 -31 -31 -31 -31 -31 -31 -31 -31 -31 -31 -31 -31
-31 -31 -31 -31 -31 -31 -31 -31 -31 -31 -31 -31 -31 -31 -31 -31 -31 -31 -31 -31 -31 -31 -31 -31 -31
-31 -31 -31 -31 -31 -31 -31 -31 -31 -31 -31 -31 -31 -31 -31 -31 -31 -31 -31 -31 -31 -31 -31 -31 -31
-31 -31 -31 -31 -31 -31 -31 -31 -31 -31 -31 -31 -31 -31 -31 -31 -31 -31 -31 -31 -31 -31 -31 -31 -31
-31 -31 -31 -31 -31 -31 -31 -31 -31 -31 -31 -31 -31 -31 -31 -31 -31 -31 -31 -31 -31 -31 -31 -31 -31
-31 -31 -31 -31 -31 -31 -31 -31 -31 -31 -31 -31 -31 -31 -31 -31 -31 -31 -31 -31 -31 -31 -31 -31 -31
-31 -31 -31 -31 -31 -31 -31 -31 -31 -31 -31 -31 60 56 51 -31 -31 -31 -31 -31 -31 -31 -31 -31 -31
-31 -31 -31 -31 -31 -31 -31 -31 -31 -31 -31 -31 14 22 60 40 -31 -31 -31 -31 -31 -31 -31 -31 -31
-31 -31 -31 -31 -31 -31 -31 -31 -31 -31 -31 -31 0 0 56 56 38 -31 -31 -31 -31 -31 -31 -31 -31
-31 -31 -31 -31 -31 -31 -31 -31 -31 -31 -31 -31 0 0 7 13 40 -31 -31 -31 -31 -31 -31 -31 -31
-31 -31 -31 -31 -31 -31 -31 -31 21 14 6 100 100 100 0 46 -31 -31 -31 -31 -31 -31 -31 -31 -31
-31 -31 -31 -31 -31 -31 -31 40 46 14 1 100 100 100 0 0 4 46 -31 -31 -31 -31 -31 -31 -31
-31 -31 -31 -31 -31 -31 -31 -31 -31 53 0 100 0 0 0 60 56 60 -31 -31 -31 -31 -31 -31 -31
-31 -31 -31 -31 -31 -31 -31 -31 -31 4 0 100 0 3 59 54 51 58 -31 -31 -31 -31 -31 -31 -31
-31 -31 -31 -31 -31 -31 -31 -31 21 42 24 100 7 0 45 -31 51 -31 -31 -31 -31 -31 -31 -31 -31
-31 -31 -31 -31 -31 -31 -31 40 -31 -31 60 100 100 19 30 40 -31 -31 -31 -31 -31 -31 -31 -31 -31
-31 -31 -31 -31 -31 -31 -31 -31 -31 -31 38 50 100 -31 19 51 -31 -31 -31 -31 -31 -31 -31 -31 -31
-31 -31 -31 -31 -31 -31 -31 -31 -31 -31 51 4 0 -31 -31 -31 -31 -31 -31 -31 -31 -31 -31 -31 -31
-31 -31 -31 -31 -31 -31 -31 -31 -31 -31 -31 0 0 -31 -31 -31 -31 -31 -31 -31 -31 -31 -31 -31 -31
-31 -31 -31 -31 -31 -31 -31 -31 -31 -31 -31 0 0 -31 -31 -31 -31 -31 -31 -31 -31 -31 -31 -31 -31
-31 -31 -31 -31 -31 -31 -31 -31 -31 -31 -31 60 60 -31 -31 -31 -31 -31 -31 -31 -31 -31 -31 -31 -31
-31 -31 -31 -31 -31 -31 -31 -31 -31 -31 -31 -31 -31 -31 -31 -31 -31 -31 -31 -31 -31 -31 -31 -31 -31
-31 -31 -31 -31 -31 -31 -31 -31 -31 -31 -31 -31 -31 -31 -31 -31 -31 -31 -31 -31 -31 -31 -31 -31 -31
-31 -31 -31 -31 -31 -31 -31 -31 -31 -31 -31 -31 -31 -31 -31 -31 -31 -31 -31 -31 -31 -31 -31 -31 -31

RawMap-16-09-00
-31 -31 -31 -31 -31 -31 -31 -31 -31 -31 -31 -31 -31 -31 -31 -31 -31 -31 -31 -31 -31 -31 -31 -31 -31
-31 -31 -31 -31 -31 -31 -31 -31 -31 -31 -31 -31 -31 -31 -31 -31 -31 -31 -31 -31 -31 -31 -31 -31 -31
-31 -31 -31 -31 -31 -31 -31 -31 -31 -31 -31 -31 -31 -31 -31 -31 -31 -31 -31 -31 -31 -31 -31 -31 -31
-31 -31 -31 -31 -31 -31 -31 -31 -31 -31 -31 -31 -31 -31 -31 -31 -31 -31 -31 -31 -31 -31 -31 -31 -31
-31 -31 -31 -31 -31 -31 -31 -31 -31 -31 -31 -31 -31 -31 -31 -31 -31 -31 -31 -31 -31 -31 -31 -31 -31
-31 -31 -31 -31 -31 -31 -31 -31 -31 -31 -31 -31 -31 -31 -31 -31 -31 -31 -31 -31 -31 -31 -31 -31 -31
-31 -31 -31 -31 -31 -31 -31 -31 -31 -31 -31 -31 -31 -31 -31 -31 -31 -31 -31 -31 -31 -31 -31 -31 -31
-31 -31 -31 -31 -31 -31 -31 -31 -31 -31 -31 -31 60 56 51 -31 -31 -31 -31 -31 -31 -31 -31 -31 -31
-31 -31 -31 -31 -31 -31 -31 -31 -31 -31 -31 -31 14 22 60 40 -31 -31 -31 -31 -31 -31 -31 -31 -31
-31 -31 -31 -31 -31 -31 -31 -31 -31 -31 -31 -31 0 0 56 56 38 -31 -31 -31 -31 -31 -31 -31 -31
-31 -31 -31 -31 -31 -31 -31 -31 -31 -31 -31 -31 0 0 7 13 40 -31 -31 -31 -31 -31 -31 -31 -31
-31 -31 -31 -31 -31 -31 -31 -31 21 14 6 100 100 100 0 46 -31 -31 -31 -31 -31 -31 -31 -31 -31
-31 -31 -31 -31 -31 -31 -31 40 46 14 1 100 100 100 0 0 4 46 -31 -31 -31 -31 -31 -31 -31
-31 -31 -31 -31 -31 -31 -31 -31 -31 53 0 100 0 0 0 60 56 60 -31 -31 -31 -31 -31 -31 -31
-31 -31 -31 -31 -31 -31 -31 -31 -31 4 0 100 0 3 59 54 51 58 -31 -31 -31 -31 -31 -31 -31
-31 -31 -31 -31 -31 -31 -31 -31 21 42 24 100 7 0 45 -31 51 -31 -31 -31 -31 -31 -31 -31 -31
-31 -31 -31 -31 -31 -31 -31 40 -31 -31 60 100 100 19 30 40 -31 -31 -31 -31 -31 -31 -31 -31 -31
-31 -31 -31 -31 -31 -31 -31 -31 -31 -31 38 50 100 -31 19 51 -31 -31 -31 -31 -31 -31 -31 -31 -31
-31 -31 -31 -31 -31 -31 -31 -31 -31 -31 51 4 0 100 -31 -31 -31 -31 -31 -31 -31 -31 -31 -31 -31
-31 -31 -31 -31 -31 -31 -31 -31 -31 -31 -31 0 100 131 -31 -31 -31 -31 -31 -31 -31 -31 -31 -31 -31
-31 -31 -31 -31 -31 -31 -31 -31 -31 -31 -31 0 100 -31 -31 -31 -31 -31 -31 -31 -31 -31 -31 -31 -31
-31 -31 -31 -31 -31 -31 -31 -31 -31 -31 -31 42 160 -31 -31 -31 -31 -31 -31 -31 -31 -31 -31 -31 -31
-31 -31 -31 -31 -31 -31 -31 -31 -31 -31 40 -31 131 -31 -31 -31 -31 -31 -31 -31 -31 -31 -31 -31 -31
-31 -31 -31 -31 -31 -31 -31 -31 -31 -31 -31 -31 -31 -31 -31 -31 -31 -31 -31 -31 -31 -31 -31 -31 -31
-31 -31 -31 -31 -31 -31 -31 -31 -31 -31 -31 -31 -31 -31 -31 -31 -31 -31 -31 -31 -31 -31 -31 -31 -31

RawMap-16-09-09
-31 -31 -31 -31 -31 -31 -31 -31 -31 -31 -31 -31 -31 -31 -31 -31 -31 -31 -31 -31 -31 -31 -31 -31 -31
-31 -31 -31 -31 -31 -31 -31 -31 -31 -31 -31 -31 -31 -31 -31 -31 -31 -31 -31 -31 -31 -31 -31 -31 -31
-31 -31 -31 -31 -31 -31 -31 -31 -31 -31 -31 -31 -31 -31 -31 -31 -31 -31 -31 -31 -31 -31 -31 -31 -31
-31 -31 -31 -31 -31 -31 -31 -31 -31 -31 -31 -31 -31 -31 -31 -31 -31 -31 -31 -31 -31 -31 -31 -31 -31
-31 -31 -31 -31 -31 -31 -31 -31 -31 -31 -31 -31 -31 -31 -31 -31 -31 -31 -31 -31 -31 -31 -31 -31 -31
-31 -31 -31 -31 -31 -31 -31 -31 -31 -31 -31 -31 -31 -31 -31 -31 -31 -31 -31 -31 -31 -31 -31 -31 -31
-31 -31 -31 -31 -31 -31 -31 -31 -31 -31 -31 -31 -31 -31 -31 -31 -31 -31 -31 -31 -31 -31 -31 -31 -31
-31 -31 -31 -31 -31 -31 -31 -31 -31 -31 -31 -31 60 56 51 -31 -31 -31 -31 -31 -31 -31 -31 -31 -31
-31 -31 -31 -31 -31 -31 -31 -31 -31 -31 -31 -31 14 22 60 40 -31 -31 -31 -31 -31 -31 -31 -31 -31
-31 -31 -31 -31 -31 -31 -31 -31 -31 -31 -31 -31 0 0 56 56 38 -31 -31 -31 -31 -31 -31 -31 -31
-31 -31 -31 -31 -31 -31 -31 -31 -31 -31 -31 -31 0 0 7 13 40 -31 -31 -31 -31 -31 -31 -31 -31
-31 -31 -31 -31 -31 -31 -31 -31 21 14 6 100 100 100 0 46 -31 -31 -31 -31 -31 -31 -31 -31 -31
-31 -31 -31 -31 -31 -31 -31 40 46 14 1 100 100 100 0 0 4 46 -31 -31 -31 -31 -31 -31 -31
-31 -31 -31 -31 -31 -31 -31 -31 -31 53 0 100 18 0 0 60 56 60 -31 -31 -31 -31 -31 -31 -31
-31 -31 -31 -31 -31 -31 -31 -31 -31 4 0 158 31 3 59 54 51 58 -31 -31 -31 -31 -31 -31 -31
-31 -31 -31 -31 -31 -31 -31 -31 21 42 11 160 4 0 45 -31 51 -31 -31 -31 -31 -31 -31 -31 -31
-31 -31 -31 -31 -31 -31 -31 40 -31 131 0 100 100 19 30 40 -31 -31 -31 -31 -31 -31 -31 -31 -31
-31 -31 -31 -31 -31 -31 -31 -31 -31 131 100 35 100 -31 19 51 -31 -31 -31 -31 -31 -31 -31 -31 -31
-31 -31 -31 -31 -31 -31 -31 -31 -31 -31 100 4 0 100 -31 -31 -31 -31 -31 -31 -31 -31 -31 -31 -31
-31 -31 -31 -31 -31 -31 -31 -31 -31 -31 131 100 100 131 -31 -31 -31 -31 -31 -31 -31 -31 -31 -31 -31
-31 -31 -31 -31 -31 -31 -31 -31 -31 -31 -31 100 100 -31 -31 -31 -31 -31 -31 -31 -31 -31 -31 -31 -31
-31 -31 -31 -31 -31 -31 -31 -31 -31 -31 -31 42 160 -31 -31 -31 -31 -31 -31 -31 -31 -31 -31 -31 -31
-31 -31 -31 -31 -31 -31 -31 -31 -31 -31 40 -31 131 -31 -31 -31 -31 -31 -31 -31 -31 -31 -31 -31 -31
-31 -31 -31 -31 -31 -31 -31 -31 -31 -31 -31 -31 -31 -31 -31 -31 -31 -31 -31 -31 -31 -31 -31 -31 -31
-31 -31 -31 -31 -31 -31 -31 -31 -31 -31 -31 -31 -31 -31 -31 -31 -31 -31 -31 -31 -31 -31 -31 -31 -31

RawMap-16-09-19
-31 -31 -31 -31 -31 -31 -31 -31 -31 -31 -31 -31 -31 -31 -31 -31 -31 -31 -31 -31 -31 -31 -31 -31 -31
-31 -31 -31 -31 -31 -31 -31 -31 -31 -31 -31 -31 -31 -31 -31 -31 -31 -31 -31 -31 -31 -31 -31 -31 -31
-31 -31 -31 -31 -31 -31 -31 -31 -31 -31 -31 -31 -31 -31 -31 -31 -31 -31 -31 -31 -31 -31 -31 -31 -31
-31 -31 -31 -31 -31 -31 -31 -31 -31 -31 -31 -31 -31 -31 -31 -31 -31 -31 -31 -31 -31 -31 -31 -31 -31
-31 -31 -31 -31 -31 -31 -31 -31 -31 -31 -31 -31 -31 -31 -31 -31 -31 -31 -31 -31 -31 -31 -31 -31 -31
-31 -31 -31 -31 -31 -31 -31 -31 -31 -31 -31 -31 -31 -31 -31 -31 -31 -31 -31 -31 -31 -31 -31 -31 -31
-31 -31 -31 -31 -31 -31 -31 -31 -31 -31 -31 -31 -31 -31 -31 -31 -31 -31 -31 -31 -31 -31 -31 -31 -31
-31 -31 -31 -31 -31 -31 -31 -31 -31 -31 -31 -31 60 56 51 -31 -31 -31 -31 -31 -31 -31 -31 -31 -31
-31 -31 -31 -31 -31 -31 -31 -31 -31 -31 -31 -31 14 22 60 40 -31 -31 -31 -31 -31 -31 -31 -31 -31
-31 -31 -31 -31 -31 -31 -31 -31 -31 -31 -31 40 0 0 56 56 38 -31 -31 -31 -31 -31 -31 -31 -31
-31 -31 -31 -31 -31 -31 -31 -31 -31 -31 -31 48 0 0 7 13 40 -31 -31 -31 -31 -31 -31 -31 -31
-31 -31 -31 -31 -31 -31 -31 -31 21 14 6 100 100 100 0 46 40 -31 -31 -31 -31 -31 -31 -31 -31
-31 -31 -31 -31 -31 -31 -31 40 46 14 0 100 100 100 0 0 21 46 -31 -31 -31 -31 -31 -31 -31
-31 -31 -31 -31 -31 -31 -31 -31 -31 53 0 100 8 0 0 60 56 60 -31 -31 -31 -31 -31 -31 -31
-31 -31 -31 -31 -31 -31 -31 -31 -31 4 100 100 0 3 59 54 51 58 -31 -31 -31 -31 -31 -31 -31
-31 -31 -31 -31 -31 -31 -31 -31 21 142 107 160 0 3 45 -31 51 -31 -31 -31 -31 -31 -31 -31 -31
-31 -31 -31 -31 -31 -31 -31 40 -31 131 0 100 100 60 59 40 -31 -31 -31 -31 -31 -31 -31 -31 -31
-31 -31 -31 -31 -31 -31 -31 -31 -31 131 100 35 100 33 51 51 -31 -31 -31 -31 -31 -31 -31 -31 -31
-31 -31 -31 -31 -31 -31 -31 -31 -31 -31 100 4 0 118 -31 -31 -31 -31 -31 -31 -31 -31 -31 -31 -31
-31 -31 -31 -31 -31 -31 -31 -31 -31 -31 131 100 100 131 -31 -31 -31 -31 -31 -31 -31 -31 -31 -31 -31
-31 -31 -31 -31 -31 -31 -31 -31 -31 -31 -31 100 100 -31 -31 -31 -31 -31 -31 -31 -31 -31 -31 -31 -31
-31 -31 -31 -31 -31 -31 -31 -31 -31 -31 -31 42 160 -31 -31 -31 -31 -31 -31 -31 -31 -31 -31 -31 -31
-31 -31 -31 -31 -31 -31 -31 -31 -31 -31 40 -31 131 -31 -31 -31 -31 -31 -31 -31 -31 -31 -31 -31 -31
-31 -31 -31 -31 -31 -31 -31 -31 -31 -31 -31 -31 -31 -31 -31 -31 -31 -31 -31 -31 -31 -31 -31 -31 -31
-31 -31 -31 -31 -31 -31 -31 -31 -31 -31 -31 -31 -31 -31 -31 -31 -31 -31 -31 -31 -31 -31 -31 -31 -31

